########################################
#``#````````````````````````````````#``#
#``#``````````````####``````````````#``#
#``#```````````````##```````````````#``#
#``##```####````````````````####```##``#
#```````####```####``####```####```````#
#`````######```#````````#```######`````#
#`````######```#````````#```######`````#
#`````####`````#````````#`````####`````#
#`#```####`````#````````#`````####```#`#
#`##```#```````####``####```````#```##`#
#``#```#```##````#````#````##```#```#``#
#``#```#````#````#````#````#````#```#``#
#``#````````##```#````#```##````````#``#
#``#````````##```#`##`#```##````````#``#
#``#````````##```#`##`#```##````````#``#
#``#````````##```#````#```##````````#``#
#``#```#````#````#````#````#````#```#``#
#``#```#```##````#````#````##```#```#``#
#`##```#```````####``####```````#```##`#
#`#```####`````#````````#`````####```#`#
#`````####`````#````````#`````####`````#
#`````######```#````````#```######`````#
#`````######```#````````#```######`````#
#```````####```####``####```####```````#
#``##```####````````````````####```##``#
#``#```````````````##```````````````#``#
#``#``````````````####``````````````#``#
#``#````````````````````````````````#``#
########################################