########################################
#``````````````````````````````````````#
#``````````````````````````````````````#
#``````````````````````````````````````#
#``````````````````````````````````````#
#``````````````````````````````````````#
#`````#####``````######``````#####`````#
#`````#``````````````````````````#`````#
#`````#``````````````````````````#`````#
#`````#``````````````````````````#`````#
#`````#`````####````````####`````#`````#
#`````#``````````````````````````#`````#
#`````````#``````#````#``````#`````````#
#`````````#``````#````#``````#`````````#
#`````````#``````#````#``````#`````````#
#`````````#``````#````#``````#`````````#
#`````````#``````#````#``````#`````````#
#`````````#``````#````#``````#`````````#
#`````#``````````````````````````#`````#
#`````#`````####````````####`````#`````#
#`````#``````````````````````````#`````#
#`````#``````````````````````````#`````#
#`````#``````````````````````````#`````#
#`````#####``````######``````#####`````#
#``````````````````````````````````````#
#``````````````````````````````````````#
#``````````````````````````````````````#
#``````````````````````````````````````#
#``````````````````````````````````````#
########################################