96
54
# # # # # # # # # # # # # # # # # # # # # # # # # # # # # # # # # # # # # # # # # # # # # # # # # # # # # # # # # # # # # # # # # # # # # # # # # # # # # # # # # # # # # # # # # # # # # # # # 
# ` ` ` ` ` ` ` ` ` ` ` ` ` ` ` ` ` ` ` ` ` ` ` ` ` ` ` ` ` ` ` ` ` ` ` ` ` ` ` ` ` ` ` ` ` ` ` ` ` ` ` ` ` ` # # # # ` ` ` ` ` ` ` ` ` ` ` ` ` ` ` # # # # # # # # # # ` ` ` ` ` ` # # # # # # 
# ` # # # # ` ` ` ` ` ` ` ` # # # # ` ` ` ` ` ` # # ` ` ` ` ` ` ` ` ` ` # # ` ` ` ` ` ` ` ` ` ` ` ` ` ` ` ` ` ` # # ` ` ` ` ` ` ` ` ` ` ` ` ` ` ` ` # # # ` ` ` ` ` ` ` ` ` ` ` ` ` ` # # # # # 
# ` # ` ` ` ` ` ` ` ` ` ` ` ` ` ` # ` ` ` ` ` ` # # # ` ` ` ` ` ` ` ` # # # ` ` ` ` ` ` ` ` # # # # ` ` ` ` ` ` ` # ` ` ` ` ` ` ` ` ` ` ` # ` ` ` ` ` # # # ` ` ` ` ` ` ` ` ` ` ` ` ` # # # # # 
# ` # ` ` ` ` ` ` ` ` ` ` ` ` ` ` # ` ` ` ` ` ` ` # # # # ` ` ` ` # # # # ` ` ` ` ` ` ` ` ` # # # # ` ` ` ` ` ` ` ` ` ` ` ` ` ` ` ` ` ` ` # # ` ` ` ` ` # # ` ` ` ` ` ` ` ` ` ` ` ` ` # # # # # 
# ` # ` ` ` ` ` ` ` ` ` ` ` ` ` ` # ` ` ` ` ` ` ` ` ` # # # # # # # # ` ` ` ` ` ` ` ` ` ` ` # # # # ` ` ` ` ` ` ` ` ` ` ` ` ` ` ` ` ` ` # # # # ` ` ` ` # # # ` ` ` ` ` ` ` ` ` ` ` ` ` # # # # 
# ` ` ` ` ` ` ` ` ` ` ` ` ` ` ` ` ` ` ` ` ` ` ` ` ` ` ` ` ` ` ` ` ` ` ` ` ` ` ` ` ` ` ` # # # # # # # # ` ` ` # # # # # # # # # # # # # # # # # ` ` ` ` ` # # ` ` ` ` ` ` ` ` ` ` ` ` ` # # # # 
# ` ` ` ` ` ` ` ` ` ` ` ` ` ` ` ` ` ` ` ` ` ` ` ` ` ` ` ` ` ` ` ` ` ` ` ` ` ` ` ` ` ` ` ` # # # # # # ` ` ` ` ` ` ` ` ` ` ` ` ` ` ` ` ` ` ` ` ` ` ` ` ` ` # # ` ` ` ` ` ` ` ` ` ` ` ` ` # # # # 
# ` ` ` ` ` ` ` ` ` ` ` ` ` # # ` ` ` ` ` ` ` ` ` ` ` ` ` ` ` ` ` ` ` ` ` ` ` ` ` ` ` ` ` ` # # # # ` ` ` ` ` ` ` ` ` ` ` ` ` ` ` ` ` ` ` ` ` ` ` ` ` ` ` ` # ` ` ` ` ` ` ` ` ` ` ` ` ` ` # # # 
# ` # ` ` ` ` ` ` ` ` ` # # ` ` ` ` ` ` ` ` ` ` ` ` ` ` ` ` ` ` ` ` ` ` ` ` ` ` ` ` ` ` ` ` ` # # ` ` ` ` ` ` ` ` ` ` ` ` ` ` ` ` ` ` ` ` ` ` ` ` ` ` ` ` ` ` ` ` ` ` ` ` ` ` ` ` ` ` ` ` # # # 
# ` # ` ` ` ` ` ` ` # # ` ` ` ` ` ` ` ` ` ` ` ` ` ` ` ` ` ` ` ` ` ` ` ` ` ` # # # # # # ` ` ` ` ` ` ` ` # # # # # # ` ` ` ` ` ` ` ` ` ` ` ` ` ` ` ` ` ` ` ` ` ` ` ` ` # ` ` ` ` ` ` ` ` ` # # # 
# ` # ` ` ` ` ` # # ` ` ` ` ` ` ` ` ` ` ` ` ` ` ` ` ` ` ` ` ` ` ` ` ` ` ` ` # ` ` ` ` ` ` ` ` ` ` ` ` ` ` ` ` ` ` # ` ` ` ` ` ` ` ` ` ` ` ` ` ` ` ` ` ` ` ` ` ` ` ` ` # # ` ` ` ` ` ` ` ` ` # # 
# ` # # # # ` ` ` ` ` ` ` ` ` ` ` ` ` ` ` ` ` ` ` ` ` ` ` ` ` ` ` ` ` ` ` ` # ` ` ` ` ` ` ` ` ` ` ` ` ` ` ` ` ` ` # ` ` ` ` ` ` # # ` ` ` ` ` ` # # ` ` ` ` ` ` ` ` ` # # # ` ` ` ` ` ` ` ` # # 
# ` ` ` ` ` ` ` ` ` ` ` ` ` ` ` ` ` ` ` ` ` ` ` ` ` ` ` ` ` ` ` ` ` ` ` ` ` # ` ` ` ` ` ` ` ` ` ` ` ` ` ` ` ` ` ` # ` ` ` ` ` ` ` # # ` ` ` ` # # ` ` ` ` ` ` ` ` ` ` ` # # ` ` ` ` ` ` ` ` # # 
# ` ` ` ` ` ` ` ` ` ` ` ` ` # # # # # # # # ` ` ` ` ` ` ` ` ` ` ` ` ` ` ` ` # ` ` ` ` ` ` ` ` ` ` ` ` ` ` ` ` ` ` # ` ` ` ` ` ` ` ` # # ` ` # # ` ` ` ` ` ` ` ` ` ` ` ` # # # ` ` ` ` ` ` ` ` # 
# ` ` ` ` ` ` ` ` ` ` ` ` # # ` ` ` ` ` ` ` ` ` ` # # ` ` ` ` ` ` # # ` ` ` # ` ` ` ` ` ` ` ` ` ` ` ` ` ` ` ` ` ` # ` ` ` ` ` ` ` ` ` # # # # ` ` ` ` ` ` ` ` ` ` ` ` ` ` # # # ` ` ` ` ` ` ` # 
# ` ` ` ` ` ` ` ` ` ` ` # # ` ` ` ` ` ` ` ` ` ` ` ` # # ` ` ` ` # # ` ` ` ` # ` ` ` ` ` ` ` ` ` ` ` ` ` ` ` ` ` ` # ` ` ` ` ` ` ` ` ` ` # # ` ` ` ` ` ` ` ` ` # # # # # # # # # # # # # # # # # 
# ` ` ` ` ` ` ` ` ` ` ` # ` ` ` ` ` ` ` ` ` ` ` ` ` ` # # ` ` # # ` ` ` ` ` # # # # # # # ` ` ` ` ` ` # # # # # # # ` ` ` ` ` ` ` ` ` # # ` ` ` ` ` ` ` ` ` ` ` ` ` ` ` ` ` ` ` # ` ` ` ` ` ` # 
# ` ` ` ` ` ` ` ` ` ` ` # ` ` ` ` ` ` ` ` ` ` ` ` ` ` ` # # # # ` ` ` ` ` ` ` ` ` ` # ` ` ` ` ` ` ` ` ` ` # ` ` ` ` ` ` ` ` ` ` ` ` # # ` ` ` ` ` ` ` ` ` ` ` ` ` ` ` ` ` ` ` ` # ` ` ` ` ` ` # 
# ` ` ` ` ` ` ` ` ` ` ` # ` ` ` ` ` ` ` ` ` ` ` ` ` ` ` ` # # ` ` ` ` ` ` ` ` ` ` ` # ` ` ` ` ` ` ` ` ` ` # ` ` ` ` ` ` ` ` ` ` ` # # ` ` ` ` ` ` ` ` ` ` ` ` ` ` ` ` ` ` ` ` ` # ` ` ` ` ` ` # 
# # # # # ` ` ` ` ` ` ` # ` ` ` ` ` ` ` ` ` ` ` ` ` ` ` ` ` # # ` ` ` ` ` ` ` ` ` ` # ` ` ` ` ` ` ` ` ` ` # ` ` ` ` ` ` ` ` ` ` ` ` ` ` ` ` ` ` ` ` ` ` ` ` ` ` ` ` ` ` ` ` ` ` # ` ` ` ` ` ` # 
# ` ` ` ` ` ` ` ` ` ` ` # ` ` ` ` ` ` ` ` # # # ` ` ` ` ` ` ` # # ` ` ` ` ` ` ` ` ` # ` ` ` # # # # ` ` ` # ` ` ` ` ` ` ` ` ` ` ` ` ` ` ` ` ` ` # # # ` ` ` ` ` ` ` ` ` ` ` ` ` ` ` ` ` ` ` ` # 
# ` ` ` ` ` ` ` ` ` ` ` # ` ` ` ` ` ` ` ` ` ` # ` ` ` ` ` ` ` ` # # ` ` ` ` ` ` # # # ` ` ` ` ` ` ` ` ` ` # # # ` ` ` ` ` ` ` ` ` ` ` ` ` ` ` ` # ` ` ` ` ` ` ` ` ` ` # ` ` ` ` ` ` ` ` ` ` ` # 
# ` ` ` ` ` ` ` ` ` ` ` # ` ` ` ` ` ` ` ` ` ` # # ` ` ` ` ` ` ` ` ` ` ` ` ` ` ` ` ` # ` ` ` ` ` ` ` ` ` ` # ` ` ` ` ` ` ` ` ` ` ` ` ` ` ` ` ` # # ` ` ` ` ` ` ` ` ` ` # ` ` ` ` ` ` ` ` ` ` ` # 
# ` ` ` ` ` ` ` ` ` ` ` # ` ` ` ` ` ` ` ` ` ` ` # ` ` ` ` ` ` ` ` ` ` ` ` ` ` ` ` ` # # ` ` ` ` ` ` ` ` # # ` ` ` ` ` ` ` ` ` ` ` ` ` ` ` ` ` # ` ` ` ` ` ` ` ` ` ` ` # ` ` ` ` ` ` ` ` ` ` ` # 
# ` ` ` ` ` ` ` ` ` ` ` # ` ` ` ` ` ` ` ` ` ` ` # ` ` ` ` ` ` ` ` ` ` ` ` ` ` ` ` ` ` # # ` ` ` ` ` ` # # ` ` ` ` ` ` ` ` ` ` ` ` ` ` ` ` ` ` # ` ` ` ` ` ` ` ` ` ` ` # ` ` ` ` ` ` ` ` ` ` ` # 
# ` ` ` ` ` ` ` # # # # # ` ` ` ` ` ` ` ` ` ` ` # ` ` ` ` ` ` ` ` ` ` ` ` ` ` ` ` ` ` ` # # ` ` ` ` # # ` ` ` ` ` ` ` ` ` ` ` ` ` ` ` ` ` ` ` # ` ` ` ` ` ` ` ` ` ` ` # ` ` ` ` ` ` ` ` ` ` ` # 
# ` ` ` ` ` ` ` ` ` ` ` # ` ` ` ` ` ` ` ` ` ` ` # ` ` ` ` ` ` ` ` ` ` ` ` ` ` ` ` ` ` ` # # ` ` ` ` # # ` ` ` ` ` ` ` ` ` ` ` ` ` ` ` ` ` ` ` # ` ` ` ` ` ` ` ` ` ` ` # # # # # ` ` ` ` ` ` ` # 
# ` ` ` ` ` ` ` ` ` ` ` # ` ` ` ` ` ` ` ` ` ` ` # ` ` ` ` ` ` ` ` ` ` ` ` ` ` ` ` ` ` # # ` ` ` ` ` ` # # ` ` ` ` ` ` ` ` ` ` ` ` ` ` ` ` ` ` # ` ` ` ` ` ` ` ` ` ` ` # ` ` ` ` ` ` ` ` ` ` ` # 
# ` ` ` ` ` ` ` ` ` ` ` # ` ` ` ` ` ` ` ` ` ` ` # ` ` ` ` ` ` ` ` ` ` ` ` ` ` ` ` ` # # ` ` ` ` ` ` ` ` # # ` ` ` ` ` ` ` ` ` ` ` ` ` ` ` ` ` # ` ` ` ` ` ` ` ` ` ` ` # ` ` ` ` ` ` ` ` ` ` ` # 
# ` ` ` ` ` ` ` ` ` ` ` # ` ` ` ` ` ` ` ` ` ` # # ` ` ` ` ` ` ` ` ` ` ` ` ` ` ` ` ` # ` ` ` ` ` ` ` ` ` ` # ` ` ` ` ` ` ` ` ` ` ` ` ` ` ` ` ` # # ` ` ` ` ` ` ` ` ` ` # ` ` ` ` ` ` ` ` ` ` ` # 
# ` ` ` ` ` ` ` ` ` ` ` # ` ` ` ` ` ` ` ` ` ` # ` ` ` ` ` ` ` ` ` ` ` ` ` ` ` ` # # # ` ` ` ` ` ` ` ` ` ` # # # ` ` ` ` ` ` # # ` ` ` ` ` ` ` ` # ` ` ` ` ` ` ` ` ` ` # ` ` ` ` ` ` ` ` ` ` ` # 
# ` ` ` ` ` ` ` ` ` ` ` ` ` ` ` ` ` ` ` ` # # # ` ` ` ` ` ` ` ` ` ` ` ` ` ` ` ` ` ` # ` ` ` # # # # ` ` ` # ` ` ` ` ` ` ` ` ` # # ` ` ` ` ` ` ` # # # ` ` ` ` ` ` ` ` # ` ` ` ` ` ` ` ` ` ` ` # 
# ` ` ` ` ` ` # ` ` ` ` ` ` ` ` ` ` ` ` ` ` ` ` ` ` ` ` ` ` ` ` ` ` ` ` ` ` ` ` ` ` # ` ` ` ` ` ` ` ` ` ` # ` ` ` ` ` ` ` ` ` ` # # ` ` ` ` ` ` ` ` ` ` ` ` ` ` ` ` ` # ` ` ` ` ` ` ` # # # # # 
# ` ` ` ` ` ` # ` ` ` ` ` ` ` ` ` ` ` ` ` ` ` ` ` ` ` ` ` # # ` ` ` ` ` ` ` ` ` ` ` # ` ` ` ` ` ` ` ` ` ` # ` ` ` ` ` ` ` ` ` ` ` # # ` ` ` ` ` ` ` ` ` ` ` ` ` ` ` ` # ` ` ` ` ` ` ` ` ` ` ` # 
# ` ` ` ` ` ` # ` ` ` ` ` ` ` ` ` ` ` ` ` ` ` ` ` ` ` ` # # ` ` ` ` ` ` ` ` ` ` ` ` # ` ` ` ` ` ` ` ` ` ` # ` ` ` ` ` ` ` ` ` ` # # # # ` ` ` ` ` ` ` ` ` ` ` ` ` ` ` # ` ` ` ` ` ` ` ` ` ` ` # 
# ` ` ` ` ` ` # ` ` ` ` ` ` ` ` ` ` ` ` ` ` ` ` ` ` ` # # ` ` ` ` ` ` ` ` ` # # # # # # # ` ` ` ` ` ` # # # # # # # ` ` ` ` ` # # ` ` # # ` ` ` ` ` ` ` ` ` ` ` ` ` ` # ` ` ` ` ` ` ` ` ` ` ` # 
# # # # # # # # # # # # # # # # # ` ` ` ` ` ` ` ` ` # # ` ` ` ` ` ` ` ` ` ` # ` ` ` ` ` ` ` ` ` ` ` ` ` ` ` ` ` ` # ` ` ` ` # # ` ` ` ` # # ` ` ` ` ` ` ` ` ` ` ` ` # # ` ` ` ` ` ` ` ` ` ` ` # 
# ` ` ` ` ` ` ` # # # ` ` ` ` ` ` ` ` ` ` ` ` ` ` # # # # ` ` ` ` ` ` ` ` ` # ` ` ` ` ` ` ` ` ` ` ` ` ` ` ` ` ` ` # ` ` ` # # ` ` ` ` ` ` # # ` ` ` ` ` ` ` ` ` ` # # ` ` ` ` ` ` ` ` ` ` ` ` # 
# ` ` ` ` ` ` ` ` # # # ` ` ` ` ` ` ` ` ` ` ` ` # # ` ` # # ` ` ` ` ` ` ` ` # ` ` ` ` ` ` ` ` ` ` ` ` ` ` ` ` ` ` # ` ` ` ` ` ` ` ` ` ` ` ` ` ` ` ` # # # # # # # # ` ` ` ` ` ` ` ` ` ` ` ` ` # 
# # ` ` ` ` ` ` ` ` # # ` ` ` ` ` ` ` ` ` ` ` # # ` ` ` ` # # ` ` ` ` ` ` ` # ` ` ` ` ` ` ` ` ` ` ` ` ` ` ` ` ` ` # ` ` ` ` ` ` ` ` ` ` ` ` ` ` ` ` ` ` ` ` ` ` ` ` ` ` ` ` ` ` ` ` ` ` ` ` ` # 
# # ` ` ` ` ` ` ` ` # # # ` ` ` ` ` ` ` ` ` # # ` ` ` ` ` ` # # ` ` ` ` ` ` # ` ` ` ` ` ` ` ` ` ` ` ` ` ` ` ` ` ` # ` ` ` ` ` ` ` ` ` ` ` ` ` ` ` ` ` ` ` ` ` ` ` ` ` ` ` ` ` ` ` ` # # # # ` # 
# # ` ` ` ` ` ` ` ` ` # # ` ` ` ` ` ` ` ` ` ` ` ` ` ` ` ` ` ` ` ` ` ` ` ` ` # ` ` ` ` ` ` ` ` ` ` ` ` ` ` ` ` ` ` # ` ` ` ` ` ` ` ` ` ` ` ` ` ` ` ` ` ` ` ` ` ` ` ` ` ` ` ` # # ` ` ` ` ` # ` # 
# # # ` ` ` ` ` ` ` ` ` # ` ` ` ` ` ` ` ` ` ` ` ` ` ` ` ` ` ` ` ` ` ` ` ` ` # # # # # # ` ` ` ` ` ` ` ` # # # # # # ` ` ` ` ` ` ` ` ` ` ` ` ` ` ` ` ` ` ` ` ` ` ` ` ` ` # # ` ` ` ` ` ` ` # ` # 
# # # ` ` ` ` ` ` ` ` ` ` ` ` ` ` ` ` ` ` ` ` ` ` ` ` ` ` ` ` ` ` ` ` ` ` ` ` ` ` ` ` ` ` ` ` # # ` ` ` ` ` ` ` ` ` ` ` ` ` ` ` ` ` ` ` ` ` ` ` ` ` ` ` ` ` ` ` ` ` # # ` ` ` ` ` ` ` ` ` # ` # 
# # # ` ` ` ` ` ` ` ` ` ` ` ` ` ` # ` ` ` ` ` ` ` ` ` ` ` ` ` ` ` ` ` ` ` ` ` ` ` ` ` ` ` ` # # # # ` ` ` ` ` ` ` ` ` ` ` ` ` ` ` ` ` ` ` ` ` ` ` ` ` ` ` ` ` ` # # ` ` ` ` ` ` ` ` ` ` ` ` ` # 
# # # # ` ` ` ` ` ` ` ` ` ` ` ` ` # # ` ` ` ` ` ` ` ` ` ` ` ` ` ` ` ` ` ` ` ` ` ` ` ` ` ` # # # # # # ` ` ` ` ` ` ` ` ` ` ` ` ` ` ` ` ` ` ` ` ` ` ` ` ` ` ` ` ` ` ` ` ` ` ` ` ` ` ` ` ` ` ` ` # 
# # # # ` ` ` ` ` ` ` ` ` ` ` ` ` # # ` ` ` ` ` # # # # # # # # # # # # # # # # # ` ` ` # # # # # # # # ` ` ` ` ` ` ` ` ` ` ` ` ` ` ` ` ` ` ` ` ` ` ` ` ` ` ` ` ` ` ` ` ` ` ` ` ` ` ` ` ` ` ` # 
# # # # ` ` ` ` ` ` ` ` ` ` ` ` ` # # # ` ` ` ` # # # # ` ` ` ` ` ` ` ` ` ` ` ` ` ` ` ` ` ` # # # # ` ` ` ` ` ` ` ` ` ` ` # # # # # # # # ` ` ` ` ` ` ` ` ` # ` ` ` ` ` ` ` ` ` ` ` ` ` ` # ` # 
# # # # # ` ` ` ` ` ` ` ` ` ` ` ` ` # # ` ` ` ` ` # # ` ` ` ` ` ` ` ` ` ` ` ` ` ` ` ` ` ` ` # # # # ` ` ` ` ` ` ` ` ` # # # # ` ` ` ` # # # # ` ` ` ` ` ` ` # ` ` ` ` ` ` ` ` ` ` ` ` ` ` # ` # 
# # # # # ` ` ` ` ` ` ` ` ` ` ` ` ` # # # ` ` ` ` ` # ` ` ` ` ` ` ` ` ` ` ` # ` ` ` ` ` ` ` # # # # ` ` ` ` ` ` ` ` # # # ` ` ` ` ` ` ` ` # # # ` ` ` ` ` ` # ` ` ` ` ` ` ` ` ` ` ` ` ` ` # ` # 
# # # # # ` ` ` ` ` ` ` ` ` ` ` ` ` ` # # # ` ` ` ` ` ` ` ` ` ` ` ` ` ` ` ` # # ` ` ` ` ` ` ` ` ` ` ` ` ` ` ` ` ` ` # # ` ` ` ` ` ` ` ` ` ` # # ` ` ` ` ` ` # # # # ` ` ` ` ` ` ` ` # # # # ` # 
# # # # # # ` ` ` ` ` ` # # # # # # # # # # ` ` ` ` ` ` ` ` ` ` ` ` ` ` ` # # # # ` ` ` ` ` ` ` ` ` ` ` ` ` ` ` ` ` ` ` ` ` ` ` ` ` ` ` ` ` ` ` ` ` ` ` ` ` ` ` ` ` ` ` ` ` ` ` ` ` ` ` ` ` ` # 
# # # # # # # # # # # # # # # # # # # # # # # # # # # # # # # # # # # # # # # # # # # # # # # # # # # # # # # # # # # # # # # # # # # # # # # # # # # # # # # # # # # # # # # # # # # # # # # # 