96
54
# # # # # # # # # # # # # # # # # # # # # # # # # # # # # # # # # # # # # # # # # # # # # # # # # # # # # # # # # # # # # # # # # # # # # # # # # # # # # # # # # # # # # # # # # # # # # # # # 
# ` # ` ` ` ` ` ` ` # ` ` ` ` # # ` ` ` ` ` ` ` # ` ` ` ` ` ` ` ` ` ` ` ` ` ` ` ` ` ` ` ` ` ` ` ` ` ` ` ` ` ` ` ` ` ` ` ` ` ` ` ` ` ` ` ` ` ` ` ` ` ` ` ` ` ` ` ` ` ` ` ` ` ` ` ` ` ` ` ` ` ` # 
# ` ` ` ` ` ` ` # ` # ` ` ` ` ` ` ` ` ` ` ` ` ` # ` ` ` ` ` ` ` ` ` ` ` ` ` ` ` ` ` ` # # # # # # # ` ` ` ` ` ` ` ` ` ` ` ` ` ` ` ` ` ` ` ` ` ` ` # # # # # # # ` ` ` ` ` ` ` ` ` ` ` ` ` ` ` # 
# ` ` ` ` # ` ` ` ` # ` ` ` ` # # ` ` ` ` ` ` ` # ` ` ` ` ` ` ` ` ` ` ` ` ` ` ` ` ` ` ` ` ` ` ` ` # # # # # # # # ` ` ` ` ` ` ` ` ` # # # # # # # # ` ` ` ` ` ` ` ` ` ` ` ` ` ` ` ` ` ` ` ` ` # 
# ` ` ` ` ` ` ` ` ` # ` ` ` ` # # ` ` ` ` ` ` ` # ` ` ` ` ` ` ` ` ` ` ` ` ` ` ` ` ` ` ` ` ` ` ` ` ` ` ` ` ` ` ` # # # # # # # # # # # ` ` ` ` ` ` ` ` ` ` ` ` ` ` ` ` ` ` ` ` ` ` ` ` ` ` ` ` # 
# ` ` # ` ` ` # ` ` # # # # # # # ` ` ` ` ` ` ` # ` ` ` ` ` ` ` ` ` ` ` ` ` ` ` ` ` ` ` ` ` ` ` ` ` ` ` ` ` ` ` ` ` ` ` ` ` ` ` ` ` ` ` ` ` ` ` ` ` ` ` ` ` ` ` ` ` ` ` ` ` ` ` ` ` ` ` ` ` ` # 
# ` ` ` ` ` ` ` ` ` ` ` ` ` ` # # ` ` ` ` ` ` ` # ` ` ` ` ` ` ` ` ` ` ` ` ` ` ` ` ` ` ` ` ` ` ` ` ` ` ` ` ` ` ` ` ` ` ` ` ` ` ` ` ` ` ` ` ` ` ` ` ` ` ` ` ` ` ` ` ` ` ` ` ` ` ` ` ` ` ` ` ` ` # 
# ` ` # ` ` ` ` ` ` ` ` ` ` ` # # ` ` ` ` ` ` ` # ` ` ` ` ` ` ` ` ` ` ` ` ` ` ` ` ` ` ` ` ` ` ` ` ` ` ` ` ` ` ` # # # # # # # # # # # ` ` ` ` ` ` ` ` ` ` ` ` ` ` ` ` ` ` ` ` ` ` ` ` ` ` ` ` # 
# ` ` ` ` ` ` ` ` # ` ` ` ` ` # # ` ` ` ` ` ` ` # ` ` ` ` ` ` ` ` ` ` ` ` ` ` ` ` ` ` ` ` ` ` ` ` # # # # # # # # ` ` ` ` ` ` ` ` ` # # # # # # # # ` ` ` ` ` ` ` ` ` ` ` ` ` ` ` ` ` ` ` ` ` # 
# ` ` ` ` # ` ` ` ` # ` ` ` ` # # ` ` ` ` ` ` ` # ` ` ` ` ` ` ` ` ` ` ` ` ` ` ` ` ` ` # # # # # # # ` ` ` ` ` ` ` ` ` ` ` ` ` ` ` ` ` ` ` ` ` ` ` # # # # # # # ` ` ` ` ` ` ` ` ` ` ` ` ` ` ` # 
# ` ` ` ` ` ` ` ` # ` ` ` ` ` # # ` ` ` ` ` ` ` # ` ` ` ` ` ` ` ` ` ` ` ` ` ` ` ` ` ` ` ` ` ` ` ` ` ` ` ` ` ` ` ` ` ` ` ` ` ` ` ` ` ` ` ` ` ` ` ` ` ` ` ` ` ` ` ` ` ` ` ` ` ` ` ` ` ` ` ` ` ` # 
# ` ` # ` ` # ` ` ` ` ` ` ` # # # ` ` ` ` ` # # # # # # # # # # # # # ` ` ` # # # # # # # # # # # # # # # # # # # # # # # # # # # # # # # # # # # # # # # # # # # # # ` ` ` ` ` # # # # # # # # 
# ` ` ` ` ` ` ` ` ` ` ` ` ` ` # # ` ` ` ` # # ` ` ` ` ` ` ` ` ` ` ` ` ` ` ` ` ` ` ` ` ` ` ` ` ` ` ` ` ` ` ` ` ` ` ` ` ` ` ` ` ` ` ` ` ` ` ` ` ` ` ` ` ` ` ` ` ` ` ` ` ` ` ` ` ` ` ` ` ` ` ` ` # 
# ` ` ` ` # ` ` ` # ` ` ` ` ` # # ` ` ` ` # ` ` ` ` ` ` ` ` ` ` ` ` ` ` ` ` ` ` ` ` ` ` ` ` ` ` ` ` ` ` ` ` ` ` ` ` ` ` ` ` ` ` ` ` ` ` ` ` ` ` ` ` ` ` ` ` ` ` ` ` ` ` ` ` ` ` ` ` ` ` ` ` ` # 
# # ` ` ` ` ` ` ` ` ` ` ` # ` # # ` ` ` # # ` ` ` ` ` ` ` ` ` ` ` ` ` ` ` ` ` ` ` ` ` ` ` ` ` ` ` ` ` ` ` ` ` ` ` ` ` ` ` ` ` ` ` ` ` ` ` ` ` ` ` ` ` ` ` ` ` ` ` ` ` ` ` ` ` ` ` ` ` ` ` ` ` # 
# ` ` ` ` ` # ` ` ` ` # ` ` ` # # ` ` ` # ` ` ` # # # # # # # # # # # ` ` ` # # # # # # # # # # # # # # # # # # # # # # # # # # # # # # # # # # # # # # # # # # # # # # # # # # # # # # # ` ` # 
# ` ` ` ` ` ` ` ` ` ` ` ` ` ` # # ` ` ` # ` ` ` # ` ` ` ` ` ` ` ` ` ` ` ` ` ` ` ` ` ` ` ` ` ` ` ` ` ` ` ` ` ` ` ` ` ` ` ` ` ` ` ` ` ` ` ` ` ` ` ` ` ` ` ` ` ` ` ` ` ` ` ` ` ` ` ` ` ` ` # ` ` # 
# # ` ` ` ` ` ` ` ` ` ` ` ` ` # # ` ` ` # ` ` ` # ` ` ` ` ` ` ` ` ` ` ` ` ` ` ` ` ` ` ` ` ` ` ` ` ` ` ` ` ` ` ` ` ` ` ` ` ` ` ` ` ` ` ` ` ` ` ` ` ` ` ` ` ` ` ` ` ` ` ` ` ` ` ` ` ` ` ` # ` ` # 
# ` ` ` ` ` ` ` ` ` # ` ` ` ` # # ` ` ` # ` ` ` # ` ` ` ` ` ` ` ` ` ` ` ` ` ` ` ` ` ` ` ` ` ` ` ` ` ` ` ` ` ` ` ` ` ` ` ` ` ` ` ` ` ` ` ` ` ` ` ` ` ` ` ` ` ` ` ` ` ` ` ` ` ` ` ` ` ` ` # ` ` # 
# ` ` ` ` # ` ` # ` ` ` ` ` ` # # ` ` ` # ` ` ` # ` ` ` ` ` ` ` ` ` ` ` ` ` ` ` ` ` ` ` ` ` ` ` ` ` ` ` ` ` ` ` ` ` ` ` ` ` ` ` ` ` ` ` ` ` ` ` ` ` ` ` ` ` ` ` ` ` ` ` ` ` ` ` ` ` ` ` # ` ` # 
# ` # ` ` ` ` ` # ` ` ` ` ` ` # # ` ` ` # ` ` ` # ` ` ` ` ` ` ` ` ` ` ` ` ` ` ` ` ` ` ` ` ` ` ` ` ` ` ` ` ` ` ` ` ` ` ` ` ` ` ` ` ` ` ` ` ` ` ` ` ` ` ` ` ` ` ` ` ` ` ` ` ` ` ` ` ` ` ` # ` ` # 
# ` ` ` ` ` ` ` ` ` ` # ` ` # # # ` ` ` # ` ` ` # # # # # ` ` ` ` ` ` ` ` ` ` ` ` ` ` ` ` ` ` ` ` ` ` ` ` ` ` ` ` ` ` ` ` ` ` ` ` ` ` ` ` ` ` ` ` ` ` ` ` ` ` ` ` ` ` ` ` ` ` ` ` ` ` ` # ` ` # 
# ` ` ` ` ` ` ` ` ` ` ` ` ` ` # # ` ` ` # ` ` ` # ` ` ` ` ` ` ` ` ` ` ` ` ` ` ` ` ` ` ` ` ` ` ` ` ` ` ` ` ` ` ` ` ` ` ` ` ` ` ` # ` ` ` ` ` ` ` ` ` ` ` ` ` ` # ` ` ` ` ` ` ` # # # # # # ` ` # 
# ` ` # ` ` ` ` ` ` ` ` ` ` ` # # ` ` ` # ` ` ` # ` ` ` ` ` ` ` ` ` ` ` ` ` ` ` ` ` ` ` ` ` ` ` ` ` ` ` ` ` ` ` ` ` ` ` ` ` ` ` # ` ` ` ` ` ` ` ` ` ` ` ` ` ` # ` ` ` ` ` ` ` # ` ` ` ` ` ` ` # 
# ` ` ` ` ` ` ` ` ` ` ` # ` ` # # ` ` ` # ` ` ` # ` ` ` ` ` ` ` ` ` ` ` ` ` ` ` ` ` ` ` ` ` ` ` ` ` ` ` ` ` ` ` ` ` ` ` ` ` ` ` ` # ` ` ` ` ` ` ` ` ` ` ` ` # ` ` ` ` ` ` ` ` # ` ` ` ` ` ` ` # 
# ` ` ` ` ` # ` ` # ` ` ` ` ` # # ` ` ` # ` ` ` # # # # # ` ` ` ` ` ` ` ` ` ` ` ` ` ` ` ` ` ` ` ` ` ` ` ` ` ` ` ` ` ` ` ` ` ` ` ` # ` ` ` ` ` ` ` ` ` ` ` ` # ` ` ` ` ` ` ` ` ` ` ` ` ` ` ` ` # 
# # ` ` ` ` ` ` ` ` # ` ` ` ` # # ` ` ` # ` ` ` # ` ` ` ` ` ` ` ` ` ` ` ` ` # ` ` ` # ` ` ` # ` ` ` # ` ` ` # ` ` ` # ` ` ` ` ` ` ` # ` ` ` ` ` ` ` ` ` ` # ` ` ` ` ` ` ` ` ` ` ` ` ` ` ` ` ` # 
# ` ` # ` ` ` ` ` ` ` ` # ` ` # # ` ` ` # ` ` ` # ` ` ` ` ` ` ` ` ` ` ` ` ` # ` ` ` # ` ` ` # ` ` ` # ` ` ` # ` ` ` # ` ` ` ` ` ` ` # ` ` ` ` ` ` ` ` ` ` # ` ` ` ` ` ` ` ` ` ` ` ` ` ` ` ` ` # 
# ` ` ` ` ` ` ` # ` ` ` ` ` ` # # ` ` ` # ` ` ` # ` ` ` ` ` ` ` ` ` ` ` ` ` # ` ` ` # ` ` ` # ` ` ` # ` ` ` # ` ` ` # ` ` ` ` ` ` ` ` # ` ` ` ` ` ` ` ` # ` ` ` ` ` ` ` ` ` ` # ` ` ` ` ` ` ` # 
# ` # ` ` ` ` ` ` ` ` ` ` ` ` # # ` ` ` # ` ` ` # ` ` ` ` ` ` ` ` ` ` ` ` ` # ` ` ` # ` ` ` # ` ` ` # ` ` ` # ` ` ` # ` ` ` ` ` ` ` ` # ` ` ` ` ` ` ` ` # ` ` ` ` ` ` ` ` ` ` # ` ` ` ` ` ` ` # 
# ` ` ` ` ` # ` ` ` ` ` ` # ` # # ` ` ` # ` ` ` # # # # ` ` ` # # # # # # # # # # # # # # # # # # # # # # # # # # # # # # # # # # # # # ` ` ` ` ` ` ` ` # # # # # # # # # # # # # # # # # # # # 
# ` ` ` ` ` ` ` ` ` # # # # # # # ` ` ` ` ` ` ` # ` ` ` ` ` ` ` ` ` ` ` ` ` ` ` ` ` ` ` ` ` ` ` ` ` ` ` ` ` ` ` ` ` ` ` ` ` ` ` ` ` ` # ` ` ` ` ` ` ` ` # ` ` ` ` ` ` ` ` ` ` ` ` ` ` ` ` ` ` # 
# ` ` ` ` ` # ` ` ` # ` ` ` ` # # ` ` ` ` ` ` ` # ` ` ` ` ` ` ` ` ` ` ` ` ` ` ` ` ` ` ` ` ` ` ` ` ` ` ` ` ` ` ` ` ` ` ` ` ` ` ` ` ` ` # ` ` ` ` ` ` ` ` # ` ` ` ` ` ` ` ` ` ` ` ` ` ` ` ` ` ` # 
# ` ` ` ` ` ` ` ` # # ` ` ` ` # # ` ` ` ` ` ` ` # ` ` ` ` ` ` ` ` ` ` ` ` ` ` ` ` ` ` ` ` ` ` ` ` ` ` ` ` ` ` ` ` ` ` ` ` ` ` ` ` ` ` # ` ` ` ` ` ` ` ` # ` ` ` ` ` ` ` ` ` ` ` ` ` ` ` ` ` ` # 
# ` ` ` ` ` ` ` ` ` # ` ` ` ` ` ` ` ` ` ` ` ` ` # # # # # # # # # # # # # # # # # # # # # # # # # # # # # # # # # # # # # # ` ` ` ` ` # ` ` ` ` ` ` ` ` # ` ` ` ` ` # # # # # # # # # # # # # # 
# ` # ` ` ` ` ` ` ` # ` ` ` ` # # ` ` ` ` ` ` ` ` ` ` ` ` ` ` ` ` ` ` ` ` ` ` ` ` ` ` ` ` ` ` ` ` ` ` ` ` ` ` ` ` ` ` ` ` ` ` ` ` ` ` # ` ` ` ` ` ` ` ` # ` ` ` ` ` ` ` ` ` ` ` ` ` ` ` ` ` ` # 
# ` ` ` ` ` ` ` ` ` # ` ` ` ` # # ` ` ` ` ` ` ` ` ` ` ` ` ` ` ` ` ` ` ` ` ` ` ` ` ` ` ` ` ` ` ` ` ` ` ` ` ` ` ` ` ` ` ` ` ` ` ` ` ` ` # ` ` ` ` ` ` ` ` # ` ` ` ` ` ` ` ` ` ` ` ` ` ` ` ` ` ` # 
# ` ` ` ` ` ` ` ` ` # ` ` ` ` # # ` ` ` ` ` ` ` ` ` ` ` ` ` ` ` ` ` ` ` ` ` ` ` ` ` ` ` ` ` ` ` ` ` ` ` ` ` ` ` ` ` ` ` ` ` ` ` ` ` ` # ` ` ` ` ` ` ` ` # ` ` ` ` ` ` ` ` ` ` ` ` ` ` ` ` ` ` # 
# ` ` ` ` ` ` ` # ` # ` ` ` ` # # # # # ` # # # # # # # # # # # # # # # # # # # # # # # # # # # # # ` # # # # # # ` # # # # # # # # # # ` ` ` ` ` ` ` ` # # # # # # # # # # ` # # # # # # ` # # 
# ` ` ` ` ` # ` ` ` # ` ` ` ` # # # # # ` # # # # # # # # # # # # # # # # # # # # # # # # # # # # # ` # # # # # # ` # # # # # # # # # # ` ` ` ` ` ` ` ` # # # # # # # # # # ` # # # # # # ` # # 
# ` ` ` ` ` ` ` ` ` # ` ` ` ` ` ` ` ` ` ` ` ` # ` ` ` ` ` ` ` ` ` ` ` ` ` ` ` ` ` ` ` ` ` ` ` # ` ` ` ` ` ` ` ` ` ` ` ` # ` ` ` ` ` ` ` ` ` ` ` ` ` ` ` ` ` ` ` ` ` ` # ` ` ` ` ` ` ` ` ` ` ` # 
# ` ` ` ` ` ` ` ` ` # ` ` ` ` ` ` ` ` ` ` ` ` # ` ` ` ` ` ` ` ` ` ` ` ` ` ` ` ` ` ` ` ` ` ` ` # ` ` ` ` ` ` ` ` ` ` ` ` # ` ` ` ` ` ` ` ` ` ` ` ` ` ` ` ` ` ` ` ` ` ` # ` ` ` ` ` ` ` ` ` ` ` # 
# ` # ` ` ` ` ` ` # # ` ` ` ` ` ` ` ` ` ` ` ` # ` ` ` ` ` ` ` ` ` ` ` ` ` ` ` ` ` ` ` ` ` ` ` # ` ` ` ` ` ` ` ` ` ` ` ` # ` ` ` ` ` ` ` ` ` ` ` ` ` ` ` ` ` ` ` ` ` ` # ` ` ` ` ` ` ` ` ` ` ` # 
# ` ` ` ` ` ` ` # ` # ` ` ` ` ` ` ` ` ` ` ` ` # ` ` ` ` ` ` ` ` ` ` ` ` ` ` ` ` ` ` ` ` ` ` ` # ` ` ` ` ` ` ` ` ` ` ` ` # ` ` ` ` ` ` ` ` ` ` ` ` ` ` ` ` ` ` ` ` ` ` # ` ` ` ` ` ` ` ` ` ` ` # 
# ` ` ` ` ` ` ` ` ` # # # # # # # # # # # # # # ` ` ` ` ` ` ` ` ` ` ` ` ` ` ` ` ` ` ` ` ` ` ` # # # # # # # # # # # # # # ` ` ` ` ` ` ` ` ` ` ` ` ` ` ` ` ` ` ` ` ` ` # # # # # # # # # # # ` # 
# ` ` ` ` ` ` ` ` ` ` ` ` ` ` ` ` ` ` ` ` ` ` ` ` ` ` ` ` ` ` ` ` ` ` ` ` ` ` ` ` ` ` ` ` ` ` ` ` ` ` ` ` ` ` ` ` ` ` ` ` ` ` ` ` ` ` ` ` ` ` ` ` ` ` ` ` ` ` ` ` ` ` ` ` ` ` ` ` ` ` ` ` ` ` # 
# ` ` ` ` ` ` ` ` ` ` ` ` ` ` ` ` ` ` ` ` ` ` ` ` ` ` ` ` ` ` ` ` ` ` ` ` ` ` ` ` ` ` ` ` ` ` ` ` ` ` ` ` ` ` ` ` ` ` ` ` ` ` ` ` ` ` ` ` ` ` ` ` ` ` ` ` ` ` ` ` ` ` ` ` ` ` ` ` ` ` ` ` ` # # 
# ` ` ` ` ` ` ` ` ` ` ` ` ` ` ` ` ` ` ` ` ` ` ` ` ` ` ` ` ` ` ` ` ` ` ` ` ` ` ` ` ` ` ` ` ` ` ` ` ` ` ` ` ` ` ` ` ` ` ` ` ` ` ` ` ` ` ` ` ` ` ` ` ` ` ` ` ` ` ` ` ` ` ` ` ` ` ` ` ` ` ` ` ` ` # 
# ` ` ` ` ` ` ` ` ` ` ` ` ` ` ` ` ` ` ` ` ` ` ` ` ` ` ` ` ` ` ` ` ` ` ` ` ` ` ` ` ` ` ` ` ` ` ` ` ` ` ` ` ` ` ` ` ` ` ` ` ` ` ` ` ` ` ` ` ` ` ` ` ` ` ` ` ` ` ` ` ` ` ` ` ` ` ` ` ` ` ` ` ` ` # 
# ` ` ` ` ` ` ` ` ` ` ` ` ` ` ` ` ` ` ` ` ` ` ` ` ` ` ` ` ` ` ` ` ` ` ` ` ` ` ` ` ` ` ` ` ` ` ` ` ` ` ` ` ` ` ` ` ` ` ` ` ` ` ` ` ` ` ` ` ` ` ` ` ` ` ` ` ` ` ` ` ` ` ` ` ` ` ` ` ` ` ` ` ` ` # 
# ` ` ` ` ` ` ` ` ` ` ` ` ` ` ` ` ` ` ` ` ` ` ` ` ` ` ` ` ` ` ` ` ` ` ` ` ` ` ` ` ` ` ` ` ` ` ` ` ` ` ` ` ` ` ` ` ` ` ` ` ` ` ` ` ` ` ` ` ` ` ` ` ` ` ` ` ` ` ` ` ` ` ` ` ` ` ` ` ` ` ` ` ` ` # 
# ` ` ` ` ` ` ` ` ` ` ` ` ` ` ` ` ` ` ` ` ` ` ` ` ` ` ` ` ` ` ` ` ` ` ` ` ` ` ` ` ` ` ` ` ` ` ` ` ` ` ` ` ` ` ` ` ` ` ` ` ` ` ` ` ` ` ` ` ` ` ` ` ` ` ` ` ` ` ` ` ` ` ` ` ` ` ` ` ` ` ` ` ` ` # 
# ` ` ` ` ` ` ` ` ` ` ` ` ` ` ` ` ` ` ` ` ` ` ` ` ` ` ` ` ` ` ` ` ` ` ` ` ` ` ` ` ` ` ` ` ` ` ` ` ` ` ` ` ` ` ` ` ` ` ` ` ` ` ` ` ` ` ` ` ` ` ` ` ` ` ` ` ` ` ` ` ` ` ` ` ` ` ` ` ` ` ` ` ` ` # 
# # # # # # # # # # # # # # # # # # # # # # # # # # # # # # # # # # # # # # # # # # # # # # # # # # # # # # # # # # # # # # # # # # # # # # # # # # # # # # # # # # # # # # # # # # # # # # # # 