96
54
################################################################################################
#```````````````````````#``##````##``#`````````````````####```````````````##`####`##``````######
#`####````````####``````##``######``##``````````````````##`````````````````#``##``#````````#####
#`#``````````````#```````##```##```##`````````####```````#```````````#`````##`##`##````````#####
#`#``````````````#````````###````###``````````####```````````````````##`````#````#`````````#####
#`#``````````````#``````````######````````````####``````````````````####````##``##``````````####
#```````````````````````````````````````````########```#################`````#``#```````````####
#````````````````````````````````````````````######``````````````````````````####```````````####
#`````````````##``````````````````````````````####````````````````````````````###````````````###
#`#`````````##`````````````````````````````````##`````````````````````````````####```````````###
#`#```````##``````````````````````````######````````######```````````````````````#```````````###
#`#`````##````````````````````````````#``````````````````#```````````````````````##```````````##
#`####````````````````````````````````#``````````````````#``````##``````##````````#```````````##
#`````````````````````````````````````#``````````````````#```````##````##`````````#```````````##
#`````````````########````````````````#``````````````````#````````##``##```````````````````````#
#````````````##``````````##``````##```#``````````````````#`````````####````````````````````````#
#```````````##````````````##````##````#``````````````````#``````````##`````````#################
#```````````#``````````````##``##`````#######``````#######`````````##```````````````````#``````#
#```````````#```````````````####``````````#``````````#````````````##````````````````````#``````#
#```````````#````````````````##```````````#``````````#```````````##`````````````````````#``````#
#####```````#`````````````````##``````````#``````````#``````````````````````````````````#``````#
#```````````#````````###```````##`````````#```####```#``````````````````###````````````````````#
#```````````#``````````#````````##``````###``````````###````````````````#``````````#```````````#
#```````````#``````````##`````````````````#``````````#`````````````````##``````````#```````````#
#```````````#```````````#`````````````````##````````##`````````````````#```````````#```````````#
#```````````#```````````#`````````````````###``````###`````````````````#```````````#```````````#
#```````#####```````````#`````````````````####````####`````````````````#```````````#```````````#
#```````````#```````````#`````````````````####````####`````````````````#```````````#####```````#
#```````````#```````````#`````````````````###``````###`````````````````#```````````#```````````#
#```````````#```````````#`````````````````##````````##`````````````````#```````````#```````````#
#```````````#``````````##`````````````````#``````````#`````````````````##``````````#```````````#
#```````````#``````````#````````````````###``````````###``````##````````#``````````#```````````#
#````````````````````###``````````````````#```####```#`````````##```````###````````#```````````#
#``````#``````````````````````````````````#``````````#``````````##`````````````````#```````#####
#``````#`````````````````````##```````````#``````````#```````````##````````````````#```````````#
#``````#````````````````````##````````````#``````````#``````````####```````````````#```````````#
#``````#```````````````````##`````````#######``````#######`````##``##``````````````#```````````#
#################`````````##``````````#``````````````````#````##````##````````````##```````````#
#````````````````````````####`````````#``````````````````#```##``````##``````````##````````````#
#```````````````````````##``##````````#``````````````````#````````````````########`````````````#
##```````````#`````````##````##```````#``````````````````#`````````````````````````````````````#
##```````````#````````##``````##``````#``````````````````#````````````````````````````````####`#
##```````````##```````````````````````#``````````````````#````````````````````````````##`````#`#
###```````````#```````````````````````######````````######``````````````````````````##```````#`#
###```````````####`````````````````````````````##`````````````````````````````````##`````````#`#
###````````````###````````````````````````````####``````````````````````````````##`````````````#
####```````````####``````````````````````````######````````````````````````````````````````````#
####```````````#``#`````#################```########```````````````````````````````````````````#
####``````````##``##````####``````````````````####````````````######``````````#``````````````#`#
#####`````````#````#`````##```````````````````####``````````###````###````````#``````````````#`#
#####````````##`##`##`````#```````````#```````####`````````##```##```##```````#``````````````#`#
#####````````#``##``#`````````````````##``````````````````##``######``##``````####````````####`#
######``````##`####`##```````````````####`````````````````#``##````##``#```````````````````````#
################################################################################################