96
54
################################################################################################
#``````````````````````````````````````````````````````####```````````````##########``````######
#`####````````####``````##``````````##``````````````````##````````````````###``````````````#####
#`#``````````````#``````###````````###````````####```````#```````````#`````###`````````````#####
#`#``````````````#```````####````####`````````####```````````````````##`````##`````````````#####
#`#``````````````#`````````########```````````####``````````````````####````###`````````````####
#```````````````````````````````````````````########```#################`````##`````````````####
#````````````````````````````````````````````######``````````````````````````##`````````````####
#`````````````##``````````````````````````````####````````````````````````````#``````````````###
#`#`````````##`````````````````````````````````##````````````````````````````````````````````###
#`#```````##``````````````````````````######````````######`````````````````````````#`````````###
#`#`````##````````````````````````````#``````````````````#`````````````````````````##`````````##
#`####````````````````````````````````#``````````````````#``````##``````##`````````###````````##
#`````````````````````````````````````#``````````````````#```````##````##```````````##````````##
#`````````````########````````````````#``````````````````#````````##``##````````````###````````#
#````````````##``````````##``````##```#``````````````````#`````````####``````````````###```````#
#```````````##````````````##````##````#``````````````````#``````````##`````````#################
#```````````#``````````````##``##`````#######``````#######`````````##```````````````````#``````#
#```````````#```````````````####``````````#``````````#````````````##````````````````````#``````#
#```````````#````````````````##```````````#``````````#```````````##`````````````````````#``````#
#####```````#`````````````````##``````````#``````````#``````````````````````````````````#``````#
#```````````#````````###```````##`````````#```####```#``````````````````###````````````````````#
#```````````#``````````#````````##``````###``````````###````````````````#``````````#```````````#
#```````````#``````````##`````````````````#``````````#`````````````````##``````````#```````````#
#```````````#```````````#`````````````````##````````##`````````````````#```````````#```````````#
#```````````#```````````#``````````````````##``````##``````````````````#```````````#```````````#
#```````#####```````````#```````````````````##````##```````````````````#```````````#```````````#
#```````````#```````````#```````````````````##````##```````````````````#```````````#####```````#
#```````````#```````````#``````````````````##``````##``````````````````#```````````#```````````#
#```````````#```````````#`````````````````##````````##`````````````````#```````````#```````````#
#```````````#``````````##`````````````````#``````````#`````````````````##``````````#```````````#
#```````````#``````````#````````````````###``````````###``````##````````#``````````#```````````#
#````````````````````###``````````````````#```####```#`````````##```````###````````#```````````#
#``````#``````````````````````````````````#``````````#``````````##`````````````````#```````#####
#``````#`````````````````````##```````````#``````````#```````````##````````````````#```````````#
#``````#````````````````````##````````````#``````````#``````````####```````````````#```````````#
#``````#```````````````````##`````````#######``````#######`````##``##``````````````#```````````#
#################`````````##``````````#``````````````````#````##````##````````````##```````````#
#```````###``````````````####`````````#``````````````````#```##``````##``````````##````````````#
#````````###````````````##``##````````#``````````````````#````````````````########`````````````#
##````````##```````````##````##```````#``````````````````#`````````````````````````````````````#
##````````###`````````##``````##``````#``````````````````#````````````````````````````````####`#
##`````````##`````````````````````````#``````````````````#````````````````````````````##`````#`#
###`````````#`````````````````````````######````````######``````````````````````````##```````#`#
###````````````````````````````````````````````##`````````````````````````````````##`````````#`#
###``````````````#````````````````````````````####``````````````````````````````##`````````````#
####`````````````##``````````````````````````######````````````````````````````````````````````#
####`````````````##`````#################```########```````````````````````````````````````````#
####`````````````###````####``````````````````####```````````########`````````#``````````````#`#
#####`````````````##`````##```````````````````####`````````####````####```````#``````````````#`#
#####`````````````###`````#```````````#```````####````````###````````###``````#``````````````#`#
#####``````````````###````````````````##``````````````````##``````````##``````####````````####`#
######``````##########```````````````####``````````````````````````````````````````````````````#
################################################################################################