96
54
################################################################################################
#`````````##```##``````````````````````````````````````````````````````````````````````````````#
#`````````##```##``````````````````````````````````````````````````````````````````````````````#
#`````````##```##``````````````````````````````````````````````````````````````````````````````#
#`````````#######``````````````````````````````````````````````````````````````````````````````#
#`````````#######``````````````````````````````````````````````````````````````````````````````#
#``````````````##``````````````````````````````````````````````````````````````````````````````#
#``````````````##``````````````````````````````````````````````````````````````````````````````#
#``````````````##``````````````````````````````````````````````````````````````````````````````#
#``````````````##``````````````````````````````````````````````````````````````````````````````#
#``````````````##``````````````````````````````````````````````````````````````````````````````#
#``````````````##``````````````````````````````````````````````````````````````````````````````#
#``````````````##``````````````````````````````````````````````````````````````````````````````#
#``````````````##``````````````````````````````````````````````````````````````````````````````#
#``````````````##``````````````````````````````````````````````````````````````````````````````#
#``````````````##``````````````````````````````````````````````````````````````````````````````#
#``````````````##``````````````````````````````````````````````````````````````````````````````#
#``````````````##``````````````````````````````````````````````````````````````````````````````#
#``````````````##``````````````````````````````````````````````````````````````````````````````#
#``````````````##``````````````````````````````````````````````````````````````````````````````#
#``````````````##``````````````````````````````````````````````````````````````````````````````#
#``````````````##``````````````````````````````````````````````````````````````````````````````#
#``````````````##``````````````````````````````````````````````````````````````````````````````#
#``````````````##``````````````````````````````````````````````````````````````````````````````#
#``````````````##``````````````````````````````````````````````````````````````````````````````#
#``````````````##``````````````````````````````````````````````````````````````````````````````#
#``````````````##``````````````````````````````````````````````````````````````````````````````#
#``````````````##``````````````````````````````````````````````````````````````````````````````#
#`````````#######``````````````````````````````````````````````````````````````````````````````#
#`````````#######``````````````````````````````````````````````````````````````````````````````#
#`````````##```##``````````````````````````````````````````````````````````````````````````````#
#`````````##```##``````````````````````````````````````````````````````````````````````````````#
#`````````##```##``````````````````````````````````````````````````````````````````````````````#
#`````````##```##``````````````````````````````````````````````````````````````````````````````#
#`````````##```##``````````````````````````````````````````````````````````````````````````````#
#`````````##```#####################################################````````####################
#`````````##```#####################################################````````####################
#`````````##``````````##```````````````````````##``````````##``````````````````````##``````````#
#`````````##``````````##```````````````````````##``````````##``````````````````````##``````````#
#`````````##``````````##```````````````````````##``````````##``````````````````````##``````````#
#`````````##############```````````````````````##############``````````````````````#############
#`````````##############```````````````````````##############``````````````````````#############
#``````````````````````````````````````````````````````````````````````````````````````````````#
#``````````````````````````````````````````````````````````````````````````````````````````````#
#``````````````````````````````````````````````````````````````````````````````````````````````#
#``````````````````````````````````````````````````````````````````````````````````````````````#
#``````````````````````````````````````````````````````````````````````````````````````````````#
#``````````````````````````````````````````````````````````````````````````````````````````````#
#``````````````````````````````````````````````````````````````````````````````````````````````#
#``````````````````````````````````````````````````````````````````````````````````````````````#
#``````````````````````````````````````````````````````````````````````````````````````````````#
#``````````````````````````````````````````````````````````````````````````````````````````````#
#``````````````````````````````````````````````````````````````````````````````````````````````#
################################################################################################