96
54
# # # # # # # # # # # # # # # # # # # # # # # # # # # # # # # # # # # # # # # # # # # # # # # # # # # # # # # # # # # # # # # # # # # # # # # # # # # # # # # # # # # # # # # # # # # # # # # # 
# ` ` ` ` ` ` ` ` ` # ` ` ` ` # # ` ` ` ` ` ` ` # ` ` ` ` ` ` ` ` ` ` ` ` ` ` ` ` ` ` ` ` ` ` ` ` ` ` ` ` ` ` ` ` ` ` ` ` ` ` ` ` ` ` ` ` ` ` ` ` ` ` ` ` ` ` ` ` ` ` ` ` ` ` ` ` ` ` ` ` ` ` # 
# ` ` ` ` ` ` ` ` ` # ` ` ` ` ` ` ` ` ` ` ` ` ` # ` ` ` ` ` ` ` ` ` ` ` ` ` ` ` ` ` ` # # # # # # # ` ` ` ` ` ` ` ` ` ` ` ` ` ` ` ` ` ` ` ` ` ` ` # # # # # # # ` ` ` ` ` ` ` ` ` ` ` ` ` ` ` # 
# ` ` ` ` ` ` ` ` ` # ` ` ` ` # # ` ` ` ` ` ` ` # ` ` ` ` ` ` ` ` ` ` ` ` ` ` ` ` ` ` ` ` ` ` ` ` # # # # # # # # ` ` ` ` ` ` ` ` ` # # # # # # # # ` ` ` ` ` ` ` ` ` ` ` ` ` ` ` ` ` ` ` ` ` # 
# ` ` ` ` ` ` ` ` ` # ` ` ` ` # # ` ` ` ` ` ` ` # ` ` ` ` ` ` ` ` ` ` ` ` ` ` ` ` ` ` ` ` ` ` ` ` ` ` ` ` ` ` ` # # # # # # # # # # # ` ` ` ` ` ` ` ` ` ` ` ` ` ` ` ` ` ` ` ` ` ` ` ` ` ` ` ` # 
# ` ` ` ` ` ` ` ` ` # # # # # # # ` ` ` ` ` ` ` # ` ` ` ` ` ` ` ` ` ` ` ` ` ` ` ` ` ` ` ` ` ` ` ` ` ` ` ` ` ` ` ` ` ` ` ` ` ` ` ` ` ` ` ` ` ` ` ` ` ` ` ` ` ` ` ` ` ` ` ` ` ` ` ` ` ` ` ` ` ` # 
# ` ` ` ` ` ` ` ` ` ` ` ` ` ` # # ` ` ` ` ` ` ` # ` ` ` ` ` ` ` ` ` ` ` ` ` ` ` ` ` ` ` ` ` ` ` ` ` ` ` ` ` ` ` ` ` ` ` ` ` ` ` ` ` ` ` ` ` ` ` ` ` ` ` ` ` ` ` ` ` ` ` ` ` ` ` ` ` ` ` ` ` ` # 
# ` ` ` ` ` ` ` ` ` ` ` ` ` ` # # ` ` ` ` ` ` ` # ` ` ` ` ` ` ` ` ` ` ` ` ` ` ` ` ` ` ` ` ` ` ` ` ` ` ` ` ` ` ` # # # # # # # # # # # ` ` ` ` ` ` ` ` ` ` ` ` ` ` ` ` ` ` ` ` ` ` ` ` ` ` ` ` # 
# ` ` ` ` ` ` ` ` ` ` ` ` ` ` # # ` ` ` ` ` ` ` # ` ` ` ` ` ` ` ` ` ` ` ` ` ` ` ` ` ` ` ` ` ` ` ` # # # # # # # # ` ` ` ` ` ` ` ` ` # # # # # # # # ` ` ` ` ` ` ` ` ` ` ` ` ` ` ` ` ` ` ` ` ` # 
# ` ` ` ` ` ` ` ` ` ` ` ` ` ` # # ` ` ` ` ` ` ` # ` ` ` ` ` ` ` ` ` ` ` ` ` ` ` ` ` ` # # # # # # # ` ` ` ` ` ` ` ` ` ` ` ` ` ` ` ` ` ` ` ` ` ` ` # # # # # # # ` ` ` ` ` ` ` ` ` ` ` ` ` ` ` # 
# ` ` ` ` ` ` ` ` ` ` ` ` ` ` # # ` ` ` ` ` ` ` # ` ` ` ` ` ` ` ` ` ` ` ` ` ` ` ` ` ` ` ` ` ` ` ` ` ` ` ` ` ` ` ` ` ` ` ` ` ` ` ` ` ` ` ` ` ` ` ` ` ` ` ` ` ` ` ` ` ` ` ` ` ` ` ` ` ` ` ` ` ` # 
# ` ` ` ` ` ` ` ` ` ` ` ` ` ` # # ` ` ` ` ` # # # # # # # # # # # # # ` ` ` # # # # # # # # # # # # # # # # # # # # # # # # # # # # # # # # # # # # # # # # # # # # # ` ` ` ` ` # # # # # # # # 
# ` ` ` ` ` ` ` ` ` ` ` ` ` ` # # ` ` ` ` # # ` ` ` ` ` ` ` ` ` ` ` ` ` ` ` ` ` ` ` ` ` ` ` ` ` ` ` ` ` ` ` ` ` ` ` ` ` ` ` ` ` ` ` ` ` ` ` ` ` ` ` ` ` ` ` ` ` ` ` ` ` ` ` ` ` ` ` ` ` ` ` ` # 
# ` ` ` ` ` ` ` ` ` ` ` ` ` ` # # ` ` ` ` # ` ` ` ` ` ` ` ` ` ` ` ` ` ` ` ` ` ` ` ` ` ` ` ` ` ` ` ` ` ` ` ` ` ` ` ` ` ` ` ` ` ` ` ` ` ` ` ` ` ` ` ` ` ` ` ` ` ` ` ` ` ` ` ` ` ` ` ` ` ` ` ` ` # 
# ` ` ` ` ` ` ` ` ` ` ` ` ` ` # # ` ` ` # # ` ` ` ` ` ` ` ` ` ` ` ` ` ` ` ` ` ` ` ` ` ` ` ` ` ` ` ` ` ` ` ` ` ` ` ` ` ` ` ` ` ` ` ` ` ` ` ` ` ` ` ` ` ` ` ` ` ` ` ` ` ` ` ` ` ` ` ` ` ` ` ` ` # 
# ` ` ` ` ` ` ` ` ` ` ` ` ` ` # # ` ` ` # ` ` ` # # # # # # # # # # # ` ` ` # # # # # # # # # # # # # # # # # # # # # # # # # # # # # # # # # # # # # # # # # # # # # # # # # # # # # # # ` ` # 
# ` ` ` ` ` ` ` ` ` ` ` ` ` ` # # ` ` ` # ` ` ` # ` ` ` ` ` ` ` ` ` ` ` ` ` ` ` ` ` ` ` ` ` ` ` ` ` ` ` ` ` ` ` ` ` ` ` ` ` ` ` ` ` ` ` ` ` ` ` ` ` ` ` ` ` ` ` ` ` ` ` ` ` ` ` ` ` ` ` # ` ` # 
# ` ` ` ` ` ` ` ` ` ` ` ` ` ` # # ` ` ` # ` ` ` # ` ` ` ` ` ` ` ` ` ` ` ` ` ` ` ` ` ` ` ` ` ` ` ` ` ` ` ` ` ` ` ` ` ` ` ` ` ` ` ` ` ` ` ` ` ` ` ` ` ` ` ` ` ` ` ` ` ` ` ` ` ` ` ` ` ` ` # ` ` # 
# ` ` ` ` ` ` ` ` ` ` ` ` ` ` # # ` ` ` # ` ` ` # ` ` ` ` ` ` ` ` ` ` ` ` ` ` ` ` ` ` ` ` ` ` ` ` ` ` ` ` ` ` ` ` ` ` ` ` ` ` ` ` ` ` ` ` ` ` ` ` ` ` ` ` ` ` ` ` ` ` ` ` ` ` ` ` ` ` ` # ` ` # 
# ` ` ` ` ` ` ` ` ` ` ` ` ` ` # # ` ` ` # ` ` ` # ` ` ` ` ` ` ` ` ` ` ` ` ` ` ` ` ` ` ` ` ` ` ` ` ` ` ` ` ` ` ` ` ` ` ` ` ` ` ` ` ` ` ` ` ` ` ` ` ` ` ` ` ` ` ` ` ` ` ` ` ` ` ` ` ` ` ` # ` ` # 
# ` ` ` ` ` ` ` ` ` ` ` ` ` ` # # ` ` ` # ` ` ` # ` ` ` ` ` ` ` ` ` ` ` ` ` ` ` ` ` ` ` ` ` ` ` ` ` ` ` ` ` ` ` ` ` ` ` ` ` ` ` ` ` ` ` ` ` ` ` ` ` ` ` ` ` ` ` ` ` ` ` ` ` ` ` ` ` ` ` # ` ` # 
# ` ` ` ` ` ` ` ` ` ` ` ` ` ` # # ` ` ` # ` ` ` # # # # # ` ` ` ` ` ` ` ` ` ` ` ` ` ` ` ` ` ` ` ` ` ` ` ` ` ` ` ` ` ` ` ` ` ` ` ` ` ` ` ` ` ` ` ` ` ` ` ` ` ` ` ` ` ` ` ` ` ` ` ` ` ` ` # ` ` # 
# ` ` ` ` ` ` ` ` ` ` ` ` ` ` # # ` ` ` # ` ` ` # ` ` ` ` ` ` ` ` ` ` ` ` ` ` ` ` ` ` ` ` ` ` ` ` ` ` ` ` ` ` ` ` ` ` ` ` ` ` ` # ` ` ` ` ` ` ` ` ` ` ` ` ` ` # ` ` ` ` ` ` ` # # # # # # ` ` # 
# ` ` ` ` ` ` ` ` ` ` ` ` ` ` # # ` ` ` # ` ` ` # ` ` ` ` ` ` ` ` ` ` ` ` ` ` ` ` ` ` ` ` ` ` ` ` ` ` ` ` ` ` ` ` ` ` ` ` ` ` ` # ` ` ` ` ` ` ` ` ` ` ` ` ` ` # ` ` ` ` ` ` ` # ` ` ` ` ` ` ` # 
# ` ` ` ` ` ` ` ` ` ` ` ` ` ` # # ` ` ` # ` ` ` # ` ` ` ` ` ` ` ` ` ` ` ` ` ` ` ` ` ` ` ` ` ` ` ` ` ` ` ` ` ` ` ` ` ` ` ` ` ` ` ` # ` ` ` ` ` ` ` ` ` ` ` ` # ` ` ` ` ` ` ` ` # ` ` ` ` ` ` ` # 
# ` ` ` ` ` ` ` ` ` ` ` ` ` ` # # ` ` ` # ` ` ` # # # # # ` ` ` ` ` ` ` ` ` ` ` ` ` ` ` ` ` ` ` ` ` ` ` ` ` ` ` ` ` ` ` ` ` ` ` ` # ` ` ` ` ` ` ` ` ` ` ` ` # ` ` ` ` ` ` ` ` ` ` ` ` ` ` ` ` # 
# ` ` ` ` ` ` ` ` ` ` ` ` ` ` # # ` ` ` # ` ` ` # ` ` ` ` ` ` ` ` ` ` ` ` ` # ` ` ` # ` ` ` # ` ` ` # ` ` ` # ` ` ` # ` ` ` ` ` ` ` # ` ` ` ` ` ` ` ` ` ` # ` ` ` ` ` ` ` ` ` ` ` ` ` ` ` ` ` # 
# ` ` ` ` ` ` ` ` ` ` ` ` ` ` # # ` ` ` # ` ` ` # ` ` ` ` ` ` ` ` ` ` ` ` ` # ` ` ` # ` ` ` # ` ` ` # ` ` ` # ` ` ` # ` ` ` ` ` ` ` # ` ` ` ` ` ` ` ` ` ` # ` ` ` ` ` ` ` ` ` ` ` ` ` ` ` ` ` # 
# ` ` ` ` ` ` ` ` ` ` ` ` ` ` # # ` ` ` # ` ` ` # ` ` ` ` ` ` ` ` ` ` ` ` ` # ` ` ` # ` ` ` # ` ` ` # ` ` ` # ` ` ` # ` ` ` ` ` ` ` ` # ` ` ` ` ` ` ` ` # ` ` ` ` ` ` ` ` ` ` # ` ` ` ` ` ` ` # 
# ` ` ` ` ` ` ` ` ` ` ` ` ` ` # # ` ` ` # ` ` ` # ` ` ` ` ` ` ` ` ` ` ` ` ` # ` ` ` # ` ` ` # ` ` ` # ` ` ` # ` ` ` # ` ` ` ` ` ` ` ` # ` ` ` ` ` ` ` ` # ` ` ` ` ` ` ` ` ` ` # ` ` ` ` ` ` ` # 
# ` ` ` ` ` ` ` ` ` ` ` ` ` ` # # ` ` ` # ` ` ` # # # # ` ` ` # # # # # # # # # # # # # # # # # # # # # # # # # # # # # # # # # # # # # ` ` ` ` ` ` ` ` # # # # # # # # # # # # # # # # # # # # 
# ` ` ` ` ` ` ` ` ` # # # # # # # ` ` ` ` ` ` ` # ` ` ` ` ` ` ` ` ` ` ` ` ` ` ` ` ` ` ` ` ` ` ` ` ` ` ` ` ` ` ` ` ` ` ` ` ` ` ` ` ` ` # ` ` ` ` ` ` ` ` # ` ` ` ` ` ` ` ` ` ` ` ` ` ` ` ` ` ` # 
# ` ` ` ` ` ` ` ` ` # ` ` ` ` # # ` ` ` ` ` ` ` # ` ` ` ` ` ` ` ` ` ` ` ` ` ` ` ` ` ` ` ` ` ` ` ` ` ` ` ` ` ` ` ` ` ` ` ` ` ` ` ` ` ` # ` ` ` ` ` ` ` ` # ` ` ` ` ` ` ` ` ` ` ` ` ` ` ` ` ` ` # 
# ` ` ` ` ` ` ` ` ` # ` ` ` ` # # ` ` ` ` ` ` ` # ` ` ` ` ` ` ` ` ` ` ` ` ` ` ` ` ` ` ` ` ` ` ` ` ` ` ` ` ` ` ` ` ` ` ` ` ` ` ` ` ` ` # ` ` ` ` ` ` ` ` # ` ` ` ` ` ` ` ` ` ` ` ` ` ` ` ` ` ` # 
# ` ` ` ` ` ` ` ` ` # ` ` ` ` ` ` ` ` ` ` ` ` ` # # # # # # # # # # # # # # # # # # # # # # # # # # # # # # # # # # # # # # ` ` ` ` ` # ` ` ` ` ` ` ` ` # ` ` ` ` ` # # # # # # # # # # # # # # 
# ` ` ` ` ` ` ` ` ` # ` ` ` ` # # ` ` ` ` ` ` ` ` ` ` ` ` ` ` ` ` ` ` ` ` ` ` ` ` ` ` ` ` ` ` ` ` ` ` ` ` ` ` ` ` ` ` ` ` ` ` ` ` ` ` # ` ` ` ` ` ` ` ` # ` ` ` ` ` ` ` ` ` ` ` ` ` ` ` ` ` ` # 
# ` ` ` ` ` ` ` ` ` # ` ` ` ` # # ` ` ` ` ` ` ` ` ` ` ` ` ` ` ` ` ` ` ` ` ` ` ` ` ` ` ` ` ` ` ` ` ` ` ` ` ` ` ` ` ` ` ` ` ` ` ` ` ` ` # ` ` ` ` ` ` ` ` # ` ` ` ` ` ` ` ` ` ` ` ` ` ` ` ` ` ` # 
# ` ` ` ` ` ` ` ` ` # ` ` ` ` # # ` ` ` ` ` ` ` ` ` ` ` ` ` ` ` ` ` ` ` ` ` ` ` ` ` ` ` ` ` ` ` ` ` ` ` ` ` ` ` ` ` ` ` ` ` ` ` ` ` ` # ` ` ` ` ` ` ` ` # ` ` ` ` ` ` ` ` ` ` ` ` ` ` ` ` ` ` # 
# ` ` ` ` ` ` ` ` ` # ` ` ` ` # # # # # ` # # # # # # # # # # # # # # # # # # # # # # # # # # # # # ` # # # # # # ` # # # # # # # # # # ` ` ` ` ` ` ` ` # # # # # # # # # # ` # # # # # # ` # # 
# ` ` ` ` ` ` ` ` ` # ` ` ` ` # # # # # ` # # # # # # # # # # # # # # # # # # # # # # # # # # # # # ` # # # # # # ` # # # # # # # # # # ` ` ` ` ` ` ` ` # # # # # # # # # # ` # # # # # # ` # # 
# ` ` ` ` ` ` ` ` ` # ` ` ` ` ` ` ` ` ` ` ` ` # ` ` ` ` ` ` ` ` ` ` ` ` ` ` ` ` ` ` ` ` ` ` ` # ` ` ` ` ` ` ` ` ` ` ` ` # ` ` ` ` ` ` ` ` ` ` ` ` ` ` ` ` ` ` ` ` ` ` # ` ` ` ` ` ` ` ` ` ` ` # 
# ` ` ` ` ` ` ` ` ` # ` ` ` ` ` ` ` ` ` ` ` ` # ` ` ` ` ` ` ` ` ` ` ` ` ` ` ` ` ` ` ` ` ` ` ` # ` ` ` ` ` ` ` ` ` ` ` ` # ` ` ` ` ` ` ` ` ` ` ` ` ` ` ` ` ` ` ` ` ` ` # ` ` ` ` ` ` ` ` ` ` ` # 
# ` ` ` ` ` ` ` ` ` # ` ` ` ` ` ` ` ` ` ` ` ` # ` ` ` ` ` ` ` ` ` ` ` ` ` ` ` ` ` ` ` ` ` ` ` # ` ` ` ` ` ` ` ` ` ` ` ` # ` ` ` ` ` ` ` ` ` ` ` ` ` ` ` ` ` ` ` ` ` ` # ` ` ` ` ` ` ` ` ` ` ` # 
# ` ` ` ` ` ` ` ` ` # ` ` ` ` ` ` ` ` ` ` ` ` # ` ` ` ` ` ` ` ` ` ` ` ` ` ` ` ` ` ` ` ` ` ` ` # ` ` ` ` ` ` ` ` ` ` ` ` # ` ` ` ` ` ` ` ` ` ` ` ` ` ` ` ` ` ` ` ` ` ` # ` ` ` ` ` ` ` ` ` ` ` # 
# ` ` ` ` ` ` ` ` ` # # # # # # # # # # # # # # ` ` ` ` ` ` ` ` ` ` ` ` ` ` ` ` ` ` ` ` ` ` ` # # # # # # # # # # # # # # ` ` ` ` ` ` ` ` ` ` ` ` ` ` ` ` ` ` ` ` ` ` # # # # # # # # # # # # # 
# ` ` ` ` ` ` ` ` ` ` ` ` ` ` ` ` ` ` ` ` ` ` ` ` ` ` ` ` ` ` ` ` ` ` ` ` ` ` ` ` ` ` ` ` ` ` ` ` ` ` ` ` ` ` ` ` ` ` ` ` ` ` ` ` ` ` ` ` ` ` ` ` ` ` ` ` ` ` ` ` ` ` ` ` ` ` ` ` ` ` ` ` ` ` # 
# ` ` ` ` ` ` ` ` ` ` ` ` ` ` ` ` ` ` ` ` ` ` ` ` ` ` ` ` ` ` ` ` ` ` ` ` ` ` ` ` ` ` ` ` ` ` ` ` ` ` ` ` ` ` ` ` ` ` ` ` ` ` ` ` ` ` ` ` ` ` ` ` ` ` ` ` ` ` ` ` ` ` ` ` ` ` ` ` ` ` ` ` ` ` # 
# ` ` ` ` ` ` ` ` ` ` ` ` ` ` ` ` ` ` ` ` ` ` ` ` ` ` ` ` ` ` ` ` ` ` ` ` ` ` ` ` ` ` ` ` ` ` ` ` ` ` ` ` ` ` ` ` ` ` ` ` ` ` ` ` ` ` ` ` ` ` ` ` ` ` ` ` ` ` ` ` ` ` ` ` ` ` ` ` ` ` ` ` ` ` # 
# ` ` ` ` ` ` ` ` ` ` ` ` ` ` ` ` ` ` ` ` ` ` ` ` ` ` ` ` ` ` ` ` ` ` ` ` ` ` ` ` ` ` ` ` ` ` ` ` ` ` ` ` ` ` ` ` ` ` ` ` ` ` ` ` ` ` ` ` ` ` ` ` ` ` ` ` ` ` ` ` ` ` ` ` ` ` ` ` ` ` ` ` ` ` # 
# ` ` ` ` ` ` ` ` ` ` ` ` ` ` ` ` ` ` ` ` ` ` ` ` ` ` ` ` ` ` ` ` ` ` ` ` ` ` ` ` ` ` ` ` ` ` ` ` ` ` ` ` ` ` ` ` ` ` ` ` ` ` ` ` ` ` ` ` ` ` ` ` ` ` ` ` ` ` ` ` ` ` ` ` ` ` ` ` ` ` ` ` ` ` # 
# ` ` ` ` ` ` ` ` ` ` ` ` ` ` ` ` ` ` ` ` ` ` ` ` ` ` ` ` ` ` ` ` ` ` ` ` ` ` ` ` ` ` ` ` ` ` ` ` ` ` ` ` ` ` ` ` ` ` ` ` ` ` ` ` ` ` ` ` ` ` ` ` ` ` ` ` ` ` ` ` ` ` ` ` ` ` ` ` ` ` ` ` ` ` # 
# ` ` ` ` ` ` ` ` ` ` ` ` ` ` ` ` ` ` ` ` ` ` ` ` ` ` ` ` ` ` ` ` ` ` ` ` ` ` ` ` ` ` ` ` ` ` ` ` ` ` ` ` ` ` ` ` ` ` ` ` ` ` ` ` ` ` ` ` ` ` ` ` ` ` ` ` ` ` ` ` ` ` ` ` ` ` ` ` ` ` ` ` ` ` # 
# ` ` ` ` ` ` ` ` ` ` ` ` ` ` ` ` ` ` ` ` ` ` ` ` ` ` ` ` ` ` ` ` ` ` ` ` ` ` ` ` ` ` ` ` ` ` ` ` ` ` ` ` ` ` ` ` ` ` ` ` ` ` ` ` ` ` ` ` ` ` ` ` ` ` ` ` ` ` ` ` ` ` ` ` ` ` ` ` ` ` ` ` ` ` # 
# # # # # # # # # # # # # # # # # # # # # # # # # # # # # # # # # # # # # # # # # # # # # # # # # # # # # # # # # # # # # # # # # # # # # # # # # # # # # # # # # # # # # # # # # # # # # # # # 