96
54
# # # # # # # # # # # # # # # # # # # # # # # # # # # # # # # # # # # # # # # # # # # # # # # # # # # # # # # # # # # # # # # # # # # # # # # # # # # # # # # # # # # # # # # # # # # # # # # # 
# ` ` ` ` ` ` ` ` ` ` ` ` ` ` ` ` ` ` ` ` ` ` ` ` ` ` ` ` ` ` ` ` ` ` ` ` ` ` ` ` ` ` ` ` ` ` ` ` ` ` ` ` ` ` ` ` ` ` ` ` ` ` ` ` ` ` ` ` # # # # # # # ` ` ` ` ` ` ` ` ` ` ` ` ` ` ` ` ` ` ` # 
# ` ` ` ` ` ` ` ` ` ` ` ` ` ` ` ` ` ` ` ` ` ` ` ` ` ` ` ` ` ` ` ` ` ` ` ` ` ` ` ` ` ` ` ` ` ` ` ` ` ` ` ` ` ` ` ` ` ` ` ` ` ` ` ` ` ` ` ` ` # # # # ` ` ` ` ` ` ` ` ` ` ` ` ` ` ` ` ` ` ` ` ` # 
# ` ` ` ` ` ` ` ` ` ` ` ` ` ` ` ` # # # # ` ` ` ` ` ` ` ` ` ` ` ` ` ` ` ` ` ` ` ` ` ` ` ` ` ` ` ` ` ` ` ` ` ` ` ` ` ` ` ` ` ` ` ` ` ` ` ` ` ` # ` ` ` ` ` ` ` ` ` ` ` ` ` ` ` ` ` ` ` ` ` ` ` # 
# ` ` ` ` ` ` ` ` # # ` ` ` ` ` ` ` ` ` # # ` ` ` ` ` ` ` # # ` ` ` ` ` ` ` ` ` ` ` ` # # # # # # # # # # ` ` ` ` ` ` ` ` ` ` ` ` ` ` # ` ` ` ` ` ` ` ` # ` ` ` ` ` ` ` # # ` ` ` ` ` ` ` ` ` # 
# ` ` ` ` ` ` ` ` # # ` ` ` ` ` ` ` ` ` ` # # ` ` ` ` ` ` # # ` ` ` ` ` ` ` ` ` ` ` ` ` ` ` ` ` ` ` ` ` ` ` ` ` ` ` ` ` ` ` ` ` ` ` ` ` # ` ` ` ` ` ` # ` ` ` ` ` ` ` ` # # ` ` ` ` ` ` ` ` ` # 
# ` ` ` ` ` ` ` ` ` ` ` ` ` ` ` ` # # ` ` ` # ` ` ` ` ` ` # # ` ` ` ` ` ` ` ` ` ` ` ` ` ` ` ` ` ` ` ` ` ` ` ` ` ` ` ` ` ` ` ` ` ` ` ` ` # ` ` ` ` ` # ` ` ` ` ` ` ` ` ` ` ` ` ` ` ` ` ` ` ` ` # 
# ` ` ` ` ` ` ` ` ` ` # # ` ` ` ` ` # ` ` ` # ` ` ` ` ` ` ` ` ` ` ` ` ` ` ` ` ` ` ` ` ` ` ` ` ` ` ` ` ` ` # # # ` ` ` ` ` ` ` ` ` ` ` ` ` # ` ` ` # ` ` ` ` ` ` ` ` ` ` ` ` ` ` ` ` ` ` ` ` ` # 
# ` ` ` ` ` ` ` ` ` ` # # ` ` ` ` ` # # ` ` # ` ` ` ` ` ` ` ` ` ` ` # ` ` ` ` ` ` ` ` ` ` ` ` ` ` ` ` ` ` # # # ` ` ` ` ` # ` ` ` ` ` ` ` # ` ` # ` ` ` ` ` ` ` ` ` ` ` ` ` ` ` ` ` ` ` ` ` ` # 
# ` ` ` ` ` ` ` ` ` ` ` ` ` ` ` ` ` ` # ` ` # # ` ` ` ` ` ` ` ` ` # ` ` ` ` ` ` ` ` ` ` ` ` ` ` ` ` ` ` ` ` ` ` ` ` ` ` ` ` # ` ` ` ` ` ` ` # # ` ` ` ` ` ` ` ` ` ` ` ` ` ` ` ` ` ` ` ` ` ` ` # 
# ` ` ` ` ` ` ` ` ` ` ` ` ` ` ` ` ` ` # ` ` ` # ` ` ` ` ` ` ` ` # ` ` ` ` ` ` ` ` ` ` ` ` ` ` ` ` ` ` ` ` ` ` ` ` ` ` ` ` ` ` # ` ` ` ` ` ` # ` ` ` ` ` ` ` ` ` ` ` ` ` ` ` ` ` ` ` ` ` ` ` ` # 
# ` ` ` ` # # # ` ` ` ` ` ` # # # ` ` # ` ` ` # ` ` ` ` ` ` ` # ` ` ` ` ` ` ` ` ` ` ` ` # # # # ` ` ` ` ` ` ` ` ` ` ` ` ` ` ` ` # ` ` ` ` ` ` ` ` ` ` ` ` ` ` # # # ` ` ` ` ` ` # # # # # # # # 
# ` ` ` ` ` ` # # ` ` ` ` # # ` ` ` ` # # ` ` # ` ` ` ` ` ` # ` ` ` ` ` ` ` ` ` ` # # # # ` ` ` ` ` ` ` ` ` ` ` ` ` ` ` ` ` ` ` ` # ` ` ` ` ` ` ` ` ` ` ` ` ` ` ` # # ` ` ` ` # # ` ` ` ` ` ` # 
# # ` ` ` ` ` ` # ` ` ` ` # ` ` ` ` ` ` # ` ` # ` ` ` ` ` # ` ` ` ` ` ` ` ` ` # # # ` ` ` ` ` ` ` ` ` ` ` ` ` ` ` ` ` ` ` ` ` ` ` ` # ` ` ` ` ` ` ` ` ` ` ` ` ` ` ` # ` ` ` ` # ` ` ` ` ` ` ` # 
# # ` ` ` ` ` ` # ` ` ` ` # ` ` ` ` ` ` # ` ` # # ` ` ` ` ` ` ` ` ` ` ` ` # # # ` ` ` ` ` ` ` ` ` ` ` ` ` ` ` ` ` ` ` ` ` ` ` ` ` ` ` ` ` ` ` ` ` ` ` ` ` ` ` ` ` ` # ` ` ` ` # ` ` ` ` ` ` ` # 
# ` # ` ` ` ` ` # ` ` ` ` # ` ` ` ` ` ` # ` ` ` # # ` ` ` ` ` ` ` ` ` ` # # ` ` ` ` ` ` ` ` ` # # # # # # # # # # ` ` ` ` ` ` ` ` ` ` ` ` ` # # ` ` ` ` ` ` ` ` ` ` # ` ` ` ` # ` ` ` ` ` ` ` # 
# ` # ` ` ` ` ` # ` ` ` ` # ` ` ` ` ` ` # ` ` ` ` # # # ` ` ` ` ` ` ` # # ` ` ` ` ` ` ` # # # # ` ` ` ` ` ` ` ` ` ` ` ` ` ` ` ` ` ` ` ` ` ` # # ` ` ` ` ` ` ` ` ` ` # ` ` ` ` # ` ` ` ` ` ` ` # 
# ` ` # ` ` ` ` # ` # # ` # ` ` ` ` ` ` # # ` ` ` ` ` ` ` ` ` ` ` ` # # ` ` ` ` ` # # # # ` ` ` ` ` ` ` ` ` ` ` ` ` ` ` # ` ` ` ` ` ` ` ` ` # # ` ` ` ` ` ` ` ` ` ` # ` # # ` # ` ` ` ` ` ` ` # 
# ` ` # ` ` ` ` # ` ` ` ` # ` ` ` ` ` ` ` # # ` ` ` ` ` ` ` ` ` ` # # ` ` ` ` ` # # ` ` ` ` ` ` ` ` ` ` ` ` ` ` ` ` ` ` # # ` ` ` ` ` ` ` ` ` ` ` ` ` ` ` ` ` ` ` ` # ` ` ` ` # ` ` ` ` ` ` ` # 
# ` ` ` ` ` ` ` # ` ` ` ` # ` ` ` ` ` ` ` ` # # # # ` ` ` ` ` ` ` # ` ` ` ` ` # # ` ` ` ` ` ` ` ` ` ` ` ` ` ` ` ` ` ` ` ` # # ` ` ` ` ` ` ` ` ` ` ` ` ` ` ` ` ` ` ` # ` ` ` ` # ` ` ` ` ` ` ` # 
# ` ` ` ` ` ` ` # ` ` ` ` # ` ` ` ` ` ` ` ` ` ` ` ` # ` ` ` ` ` ` # ` ` ` ` # # ` ` ` ` ` ` ` ` ` ` ` ` ` ` ` ` ` ` ` ` ` ` # ` ` ` ` ` ` ` ` ` ` ` ` ` ` ` ` ` ` ` # ` ` ` ` # ` ` ` ` ` ` ` # 
# ` ` ` ` ` ` ` # ` ` ` ` # ` ` ` ` ` ` ` ` ` ` ` ` ` ` ` ` ` ` ` # ` ` ` ` # ` ` ` ` ` ` ` ` ` # # # # # ` ` ` ` ` ` ` ` ` # # ` ` ` ` ` ` ` ` ` ` ` ` ` ` ` ` ` ` # ` ` ` ` # ` ` ` ` ` ` ` # 
# ` ` ` ` ` ` ` # ` ` ` ` # ` ` ` ` ` ` ` ` ` ` ` # ` ` ` ` ` ` # # ` ` ` ` # ` ` ` ` ` ` ` ` # # ` ` ` # # # ` ` ` ` ` ` ` ` # ` ` ` ` ` ` # ` ` ` ` ` ` ` ` ` ` ` # ` ` ` ` # ` ` ` ` ` ` ` # 
# ` ` ` ` ` ` ` # ` ` ` ` # ` ` ` ` ` ` ` ` ` ` ` # ` ` ` ` ` ` # ` ` ` ` ` # ` ` ` ` ` ` ` # # ` ` ` ` ` ` # # ` ` ` ` ` ` ` # ` ` ` ` ` ` # ` ` ` # # ` ` ` ` ` ` # ` ` ` ` # ` ` ` ` ` ` ` # 
# ` ` ` ` ` ` ` # ` ` ` ` # ` ` ` ` ` ` ` ` ` ` ` # ` ` ` ` ` ` # ` ` ` ` ` # ` ` ` ` ` ` ` # ` ` ` ` ` ` ` ` # # ` ` ` ` ` ` # ` ` ` ` ` ` # ` ` ` # # ` ` ` ` ` ` # ` ` ` ` # ` ` ` ` ` ` ` # 
# ` ` ` ` ` ` ` # ` ` ` ` # ` ` ` ` ` ` ` ` ` ` ` # ` ` ` ` ` ` # ` ` ` ` ` # ` ` ` ` ` ` ` ` ` ` ` ` ` ` ` ` ` # ` ` ` ` ` ` # ` ` ` ` ` ` # ` ` ` ` ` ` ` ` ` ` ` # ` ` ` ` # ` ` ` ` ` ` ` # 
# ` ` ` ` ` ` ` # ` ` # # # ` ` ` ` ` ` ` ` ` ` ` # ` ` ` ` ` ` # ` ` ` ` ` # ` ` ` ` ` ` ` ` ` ` ` ` ` ` ` ` ` # # ` ` ` ` ` # ` ` ` ` ` ` # ` ` ` ` ` ` ` ` ` ` ` # ` ` ` ` # ` ` ` ` ` ` ` # 
# ` ` ` ` ` ` ` # ` ` # # # ` ` ` ` ` ` ` ` ` ` ` # ` ` ` ` ` ` # ` ` ` ` ` # # ` ` ` ` ` ` ` ` ` ` ` ` ` ` ` ` ` # ` ` ` ` ` # ` ` ` ` ` ` # ` ` ` ` ` ` ` ` ` ` ` # ` ` ` ` # ` ` ` ` ` ` ` # 
# ` ` ` ` ` ` ` # ` ` ` ` # ` ` ` ` ` ` ` ` ` ` ` # ` ` ` ` ` ` # ` ` ` ` ` ` # ` ` ` ` ` ` ` ` ` ` ` ` ` ` ` ` ` # ` ` ` ` ` # ` ` ` ` ` ` # ` ` ` ` ` ` ` ` ` ` ` # ` ` ` ` # ` ` ` ` ` ` ` # 
# ` ` ` ` ` ` ` # ` ` ` ` # ` ` ` ` ` ` ` ` ` ` ` # ` ` ` ` ` ` # ` ` ` ` ` ` # # ` ` ` ` ` ` ` ` # ` ` ` ` ` ` ` # ` ` ` ` ` # ` ` ` ` ` ` # ` ` ` ` ` ` ` ` ` ` ` # ` ` ` ` # ` ` ` ` ` ` ` # 
# ` ` ` ` ` ` ` # ` ` ` ` # ` ` ` ` ` ` ` ` ` ` ` # ` ` ` ` ` ` # ` ` ` ` ` ` ` # # ` ` ` ` ` ` # # ` ` ` ` ` ` ` # ` ` ` ` ` # ` ` ` ` ` ` # ` ` ` ` ` ` ` ` ` ` ` # ` ` ` ` # ` # # ` ` ` ` # 
# ` ` ` ` ` ` ` # ` ` ` ` # ` ` ` ` ` ` ` ` ` ` ` # ` ` ` ` ` ` # ` ` ` ` ` ` ` ` # # # ` ` ` # # ` ` ` ` ` ` ` ` # ` ` ` ` # # ` ` ` ` ` ` # ` ` ` ` ` ` ` ` ` ` ` # ` ` ` ` # ` # # ` ` ` ` # 
# ` ` ` ` ` ` ` # ` ` ` ` # ` ` ` ` ` ` ` ` ` ` ` ` ` ` ` ` ` ` # # ` ` ` ` ` ` ` ` ` # # # # # ` ` ` ` ` ` ` ` ` # ` ` ` ` # ` ` ` ` ` ` ` ` ` ` ` ` ` ` ` ` ` ` ` # ` ` ` ` # ` ` ` ` ` ` ` # 
# ` ` ` ` ` ` ` # ` ` ` ` # ` ` ` ` ` ` ` ` ` ` ` ` ` ` ` ` ` ` ` # ` ` ` ` ` ` ` ` ` ` ` ` ` ` ` ` ` ` ` ` ` ` # # ` ` ` ` # ` ` ` ` ` ` # ` ` ` ` ` ` ` ` ` ` ` ` # ` ` ` ` # ` ` ` ` ` ` ` # 
# ` ` ` ` ` ` ` # ` ` ` ` # ` ` ` # # ` ` ` ` ` ` ` ` ` ` ` ` ` ` # # ` ` ` ` ` ` ` ` ` ` ` ` ` ` ` ` ` ` ` ` # # ` ` ` ` ` # ` ` ` ` ` ` ` # # # # ` ` ` ` ` ` ` ` # ` ` ` ` # ` ` ` ` ` ` ` # 
# ` ` ` ` ` ` ` # ` ` ` ` # ` ` ` # # ` ` ` ` ` ` ` ` ` ` ` ` ` ` ` # # ` ` ` ` ` ` ` ` ` ` ` ` ` ` ` ` ` ` # # ` ` ` ` ` # # ` ` ` ` ` ` ` ` ` ` # # ` ` ` ` ` ` ` # ` ` ` ` # ` ` ` ` # ` ` # 
# ` ` ` ` ` ` ` # ` ` ` ` # ` ` ` ` ` ` ` ` ` ` ` ` ` ` ` ` ` ` ` ` ` # ` ` ` ` ` ` ` ` ` ` ` ` ` ` ` # # # # ` ` ` ` ` # # ` ` ` ` ` ` ` ` ` ` ` ` # # ` ` ` ` ` ` # ` ` ` ` # ` ` ` ` # ` ` # 
# ` ` ` ` ` ` ` # ` # # ` # ` ` ` ` ` ` ` ` ` ` ` ` ` ` ` ` ` ` ` ` ` ` ` ` ` ` ` ` ` ` ` ` ` ` # # # # ` ` ` ` ` ` ` # # ` ` ` ` ` ` ` # # # ` ` ` ` # ` ` ` ` ` ` # ` # # ` # ` ` ` ` ` # ` # 
# ` ` ` ` ` ` ` # ` ` ` ` # ` ` ` ` ` ` ` ` ` ` # # ` ` ` ` ` ` ` ` ` ` ` ` ` # # # # # # # # # # ` ` ` ` ` ` ` ` ` # # ` ` ` ` ` ` ` ` ` ` # # ` ` ` # ` ` ` ` ` ` # ` ` ` ` # ` ` ` ` ` # ` # 
# ` ` ` ` ` ` ` # ` ` ` ` # ` ` ` ` ` ` ` ` ` ` # # ` ` ` ` ` ` ` ` ` ` ` ` ` ` ` ` ` ` ` ` ` ` ` ` ` ` ` ` ` ` # # # ` ` ` ` ` ` ` ` ` ` ` ` # # ` ` # ` ` ` ` ` ` # ` ` ` ` # ` ` ` ` ` ` # # 
# ` ` ` # # ` ` # ` ` ` ` # ` ` ` ` ` ` ` ` ` ` ` ` ` ` ` # ` ` ` ` ` ` ` ` ` ` ` ` ` ` ` ` ` ` ` ` ` ` ` ` # # # ` ` ` ` ` ` ` ` ` # ` ` ` ` ` # ` ` # ` ` ` ` ` ` # ` ` ` ` # ` ` ` ` ` ` # # 
# ` ` ` # # ` ` # ` ` ` ` # ` ` ` ` ` ` ` ` ` ` ` ` ` ` ` ` # ` ` ` ` ` ` ` ` ` ` ` ` ` ` ` ` ` ` ` ` # # # # ` ` ` ` ` ` ` ` ` ` # ` ` ` ` ` ` # ` ` # # ` ` ` ` ` # ` ` ` ` # ` ` ` ` ` ` ` # 
# ` ` ` ` ` ` # # ` ` ` ` # # ` ` ` ` ` ` ` ` ` ` ` ` ` ` ` ` # ` ` ` ` ` ` ` ` ` ` ` ` ` ` ` ` # # # # ` ` ` ` ` ` ` ` ` ` ` ` # ` ` ` ` ` ` ` # ` ` ` # ` ` ` ` # # ` ` ` ` # # ` ` ` ` ` ` # 
# # # # # # # # ` ` ` ` ` ` # # # ` ` ` ` ` ` ` ` # ` ` ` ` ` ` # ` ` ` ` ` ` ` ` ` ` ` ` ` ` ` ` ` ` ` ` ` ` ` ` ` ` ` ` ` ` # ` ` ` # # ` ` ` # ` ` ` # ` ` # # # ` ` ` ` ` ` # # # ` ` ` ` # 
# ` ` ` ` ` ` ` ` ` ` ` ` ` ` ` ` ` ` ` ` ` ` ` # # ` ` ` ` ` ` ` # ` ` ` ` ` ` ` ` ` ` ` ` ` ` ` ` ` ` ` ` ` ` ` ` ` ` ` ` # ` ` ` ` # # ` ` ` # # ` ` # ` ` ` ` ` ` ` ` ` ` ` ` ` ` ` ` ` ` # 
# ` ` ` ` ` ` ` ` ` ` ` ` ` ` ` ` ` ` ` ` ` ` # ` ` # ` ` ` ` ` ` ` # ` ` ` ` ` ` ` ` ` ` ` ` ` ` ` ` ` ` ` ` ` ` ` ` ` ` # ` ` ` ` ` ` ` ` ` ` ` # ` ` # # ` ` ` ` ` ` ` ` ` ` ` ` ` ` ` ` ` # 
# ` ` ` ` ` ` ` ` ` ` ` ` ` ` ` ` ` ` ` ` ` # ` ` ` # ` ` ` ` ` ` ` ` ` ` ` ` ` ` ` ` ` ` ` ` ` ` ` ` ` ` ` ` ` ` ` ` ` ` ` ` ` ` ` ` ` ` ` ` ` ` # ` ` ` # ` ` ` ` ` ` ` ` ` ` ` ` ` ` ` ` ` # 
# ` ` ` ` # # # ` ` ` ` ` ` ` ` ` ` ` ` ` # ` ` ` ` ` # ` ` ` ` ` ` ` ` ` ` ` ` ` ` ` ` ` ` ` ` ` ` ` ` ` ` ` ` ` ` ` ` ` ` ` ` ` ` ` ` ` ` ` ` ` # ` ` ` # # ` ` ` ` ` ` ` ` ` ` ` ` ` ` ` ` # 
# ` ` ` ` # # # ` ` ` ` ` ` ` ` ` ` ` ` # ` ` ` ` ` ` # ` ` ` ` ` ` ` ` ` ` ` ` ` ` ` ` ` ` ` ` ` ` ` ` ` ` ` ` ` ` ` ` ` ` ` ` ` ` ` ` ` ` ` ` ` # # ` ` ` ` ` ` ` ` ` ` ` ` ` ` ` ` ` ` ` ` # 
# ` ` ` ` ` ` ` ` ` ` ` ` ` ` ` ` ` ` # ` ` ` ` ` ` ` ` # ` ` ` ` ` ` ` ` ` ` ` ` ` ` # # # # # # # # # # ` ` # # ` ` ` ` ` ` ` ` ` ` ` ` ` ` ` ` ` # # ` ` ` ` ` ` ` ` ` ` ` ` ` ` ` ` ` ` ` # 
# ` ` ` ` ` ` ` ` ` ` ` ` ` ` ` ` ` ` ` ` ` ` ` # ` ` ` ` ` ` ` ` ` ` ` ` ` ` ` ` ` ` ` ` ` ` ` ` ` ` ` ` ` ` # # ` ` ` ` ` ` ` ` ` ` ` ` ` ` ` ` ` ` # # # # ` ` ` ` ` ` ` ` ` ` ` ` ` ` ` ` # 
# ` ` ` ` ` ` ` ` ` ` ` ` ` ` ` ` ` ` ` ` ` # # # # ` ` ` ` ` ` ` ` ` ` ` ` ` ` ` ` ` ` ` ` ` ` ` ` ` ` ` ` ` ` ` ` ` ` ` ` ` ` ` ` ` ` ` ` ` ` ` ` ` ` ` ` ` ` ` ` ` ` ` ` # # # ` ` ` ` ` ` # 
# ` ` ` ` ` ` ` ` ` ` ` ` ` ` ` ` ` ` ` # # # # # # # ` ` ` ` ` ` ` ` ` ` ` ` ` ` ` ` ` ` ` ` ` ` ` ` ` ` ` ` ` ` ` ` ` ` ` ` ` ` ` ` ` ` ` ` ` ` ` ` ` ` ` ` ` ` ` ` ` ` ` # # # ` ` ` ` ` ` # 
# # # # # # # # # # # # # # # # # # # # # # # # # # # # # # # # # # # # # # # # # # # # # # # # # # # # # # # # # # # # # # # # # # # # # # # # # # # # # # # # # # # # # # # # # # # # # # # # 